le - the - no hint

parole - words - no hint

più - more - no hint

usate - used - no hint

in - in - no hint

italiano - italian - no hint

ordinate - ordinate - no hint

in - in - no hint

quattro - four - no hint

categorie - categories - no hint

secondo - second - no hint

la - the - no hint

frequenza - frequency - no hint

duso - shower - no hint

da - gives - no hint

uno - one - no hint

studio - studio - no hint

fatto - done - no hint

alcuni - some - no hint

anni - years - no hint

fa - fa - no hint

risulta - turns out - no hint

che - that - no hint

queste - these - no hint

sono - i&#39;m - no hint

le - the - no hint

parole - words - no hint

più - more - no hint

usate - used - no hint

nelle - in - no hint

comuni - common - no hint

conversazioni - conversations - no hint

e - is - no hint

quindi - then - no hint

importanti - important - no hint

per - for - no hint

un - a - no hint

livello - level - no hint

intermedio - intermediate - no hint

di - of - no hint

conoscenza - knowledge - no hint

della - of the - no hint

lingua - tongue - no hint

italiana - italian - no hint

tu - you - no hint

quante - how much it is - no hint

ne - born - no hint

conosci - you know - no hint

sostantivi - nouns - no hint

aggettivi - adjectives - no hint

verbi - verbs - no hint

locuzioni - phrases - no hint

varie - various - no hint

cosa - thing - no hint

anno - year - no hint

uomo - man - no hint

giorno - day - no hint

volta - time - no hint

casa - home - no hint

parte - part - no hint

vita - life - no hint

tempo - time - no hint

donna - woman - no hint

mano - mano - no hint

occhio - eye - no hint

ora - now - no hint

signore - sir - no hint

paese - country - no hint

momento - moment - no hint

modo - way - no hint

mondo - world - no hint

parola - word - no hint

padre - dad - no hint

punto - point - no hint

lavoro - work - no hint

stato - state - no hint

caso - case - no hint

città - city - no hint

guerra - war - no hint

strada - street - no hint

figlio - son - no hint

notte - night - no hint

voce - voice - no hint

nome - name - no hint

sera - will be - no hint

acqua - water - no hint

amico - friend - no hint

fatto - done - no hint

gente - people - no hint

amore - love - no hint

storia - history - no hint

aria - air - no hint

forza - power - no hint

testa - head - no hint

ragione - reason - no hint

mare - big - no hint

mese - month - no hint

capo - boss - no hint

luce - light - no hint

sole - sole - no hint

famiglia - family - no hint

piede - foot - no hint

persona - person - no hint

via - via - no hint

signora - mrs - no hint

governo - government - no hint

senso - sense - no hint

opera - opera - no hint

prodotto - product - no hint

festa - party - no hint

gioco - game - no hint

prova - test - no hint

campagna - countryside - no hint

fiore - flower - no hint

sala - living room - no hint

misura - measure - no hint

posizione - position - no hint

natura - nature - no hint

ufficio - office - no hint

specie - species - no hint

successo - success - no hint

zona - zone - no hint

fuoco - fire - no hint

soldato - soldier - no hint

vista - sight - no hint

libertà - freedom - no hint

risultato - result - no hint

importanza - importance - no hint

dubbio - doubt - no hint

ricerca - research - no hint

dio - gave - no hint

figura - figure - no hint

piazza - square - no hint

questione - question - no hint

nemico - enemy - no hint

pena - feather - no hint

motivo - reason - no hint

esperienza - experience - no hint

ricordo - i remember - no hint

albero - tree - no hint

politica - policy - no hint

processo - process - no hint

vino - wine - no hint

porta - door - no hint

sud - south - no hint

sogno - dream - no hint

cane - dog - no hint

isola - island - no hint

movimento - movement - no hint

mente - mind - no hint

occasione - occasion - no hint

prezzo - price - no hint

causa - cause - no hint

periodo - period - no hint

sviluppo - development - no hint

sorella - sister - no hint

effetto - effect - no hint

giardino - garden - no hint

attività - activities - no hint

volontà - will - no hint

volto - face - no hint

base - base - no hint

carattere - character - no hint

coscienza - consciousness - no hint

guardia - guard - no hint

memoria - memory - no hint

terreno - ground - no hint

animale - animated - no hint

direzione - direction - no hint

eccellenza - excellence - no hint

malattia - disease - no hint

scienza - science - no hint

funzione - function - no hint

conseguenza - consequence - no hint

parete - wall - no hint

dente - tooth - no hint

distanza - distance - no hint

gusto - gusto - no hint

impressione - impression - no hint

istituto - institute - no hint

quadro - painting - no hint

attenzione - attention - no hint

autore - author - no hint

difficoltà - difficulty - no hint

passione - passion - no hint

commissione - commission - no hint

dito - here - no hint

inizio - start - no hint

programma - program - no hint

spettacolo - show - no hint

titolo - title - no hint

comunicazione - communication - no hint

fenomeno - phenomenon - no hint

maggio - may - no hint

stampa - print - no hint

denaro - money - no hint

destino - destination - no hint

dovere - must - no hint

ferro - iron - no hint

punta - tip - no hint

regno - kingdom - no hint

epoca - epoch - no hint

luna - month - no hint

provincia - province - no hint

voglia - want - no hint

differenza - difference - no hint

controllo - control - no hint

grazia - grace - no hint

passato - past - no hint

spazio - space - no hint

stella - star - no hint

corsa - running - no hint

erba - grass - no hint

massa - pulp - no hint

origine - origin - no hint

polizia - police - no hint

soluzione - solution - no hint

chilometro - kilometer - no hint

madre - mother - no hint

paura - fear - no hint

cuore - heart - no hint

idea - idea - no hint

fondo - background - no hint

esempio - example - no hint

ordine - order - no hint

posto - place - no hint

campo - field - no hint

faccia - face - no hint

moglie - wife - no hint

ragazzo - boy - no hint

bisogno - need - no hint

cielo - darling - no hint

letto - bed - no hint

fronte - front - no hint

conto - bill - no hint

corpo - body - no hint

numero - number - no hint

ministro - minister - no hint

problema - trouble - no hint

chiesa - church - no hint

braccio - arm - no hint

bambino - child - no hint

pensiero - thought - no hint

pace - pace - no hint

morte - death - no hint

fine - fine - no hint

forma - form - no hint

resto - rest - no hint

popolo - people - no hint

società - society - no hint

studio - studio - no hint

legge - law - no hint

libro - book - no hint

figlia - daughter - no hint

resto - rest - no hint

luogo - place - no hint

condizione - condition - no hint

professore - teacher - no hint

marito - husband - no hint

verità - truth - no hint

segno - sign - no hint

diritto - right - no hint

lettera - letter - no hint

ragazza - girl - no hint

scuola - school - no hint

camera - camera - no hint

gruppo - group - no hint

lira - lira - no hint

discorso - speech - no hint

centro - center - no hint

secolo - century - no hint

mezzo - half - no hint

tipo - kind - no hint

colpa - fault - no hint

rispetto - respect - no hint

scena - scene - no hint

don - don - no hint

oggetto - object - no hint

possibilità - possibility - no hint

mamma - mother - no hint

presenza - presence - no hint

teatro - theater - no hint

caffè - coffee - no hint

principio - beginning - no hint

termine - term - no hint

lingua - tongue - no hint

pezzo - piece - no hint

capello - capello - no hint

regione - region - no hint

monte - mountain - no hint

università - university - no hint

treno - train - no hint

inverno - winter - no hint

nazione - nation - no hint

pagina - page - no hint

scopo - purpose - no hint

compagno - partner - no hint

necessità - need - no hint

potere - power - no hint

musica - music - no hint

dottore - doctor - no hint

sentimento - feeling - no hint

nave - ship - no hint

pietra - stone - no hint

produzione - production - no hint

speranza - hope - no hint

dolore - pain - no hint

carne - meat - no hint

generale - general - no hint

proposito - about it - no hint

elemento - element - no hint

stazione - railway station - no hint

materia - subject - no hint

scala - ladder - no hint

maniera - manner - no hint

arma - weapon - no hint

autorità - authority - no hint

gamba - leg - no hint

patria - homeland - no hint

albergo - hotel - no hint

gioia - joy - no hint

argomento - topic - no hint

sguardo - look - no hint

relazione - report - no hint

classe - classroom - no hint

battaglia - battle - no hint

viso - total - no hint

gesto - gesture - no hint

mattino - morning - no hint

opinione - opinion - no hint

ponte - bridge - no hint

sorriso - smile - no hint

frase - phrase - no hint

limite - limit - no hint

ritorno - return - no hint

bosco - forest - no hint

esame - exam - no hint

lato - side - no hint

operazione - operation - no hint

pranzo - lunch - no hint

costa - costa - no hint

prato - meadow - no hint

repubblica - republic - no hint

valle - valley - no hint

nord - north - no hint

fatica - fatigue - no hint

odore - smell - no hint

articolo - article - no hint

costruzione - construction - no hint

rivoluzione - revolution - no hint

zia - aunt - no hint

confronto - comparison - no hint

potenza - power - no hint

sforzo - effort - no hint

sicurezza - safety - no hint

ufficiale - official - no hint

crisi - crisis - no hint

cucina - kitchen - no hint

gatto - cat - no hint

pietà - pity - no hint

territorio - territory - no hint

attimo - moment - no hint

civiltà - civilization - no hint

contatto - contact - no hint

errore - mistake - no hint

fretta - hurry - no hint

intenzione - intention - no hint

cultura - culture - no hint

giudizio - judgement - no hint

spesa - expense - no hint

aiuto - help - no hint

ambiente - ambient - no hint

animo - soul - no hint

bestia - beast - no hint

cortile - courtyard - no hint

pelle - skin - no hint

proposta - proposal - no hint

riva - shore - no hint

segretario - secretary - no hint

abito - dress - no hint

chiave - key - no hint

corrente - current - no hint

operaio - worker - no hint

corso - course - no hint

finestra - window - no hint

arte - art - no hint

sistema - system - no hint

piano - plan - no hint

bocca - mouth - no hint

anima - soul - no hint

palazzo - palace - no hint

passo - step - no hint

giornata - day - no hint

servizio - service - no hint

rapporto - relationship - no hint

milione - million - no hint

stanza - room - no hint

valore - value - no hint

colpo - blow - no hint

sangue - blood - no hint

interesse - interest - no hint

spalla - shoulder - no hint

silenzio - silence - no hint

signorina - miss - no hint

ombra - shadow - no hint

azione - action - no hint

vento - wind - no hint

mattina - morning - no hint

colore - color - no hint

presidente - president - no hint

consiglio - advice - no hint

principe - principle - no hint

viaggio - travel - no hint

genere - kind - no hint

giornale - newspaper - no hint

spirito - spirit - no hint

cavallo - horse - no hint

muro - wall - no hint

situazione - situation - no hint

linea - line - no hint

giro - round - no hint

automobile - automobile - no hint

atto - act - no hint

aspetto - appearance - no hint

età - age - no hint

fortuna - luck - no hint

oro - oro - no hint

partito - party - no hint

macchina - machine - no hint

carta - paper - no hint

minuto - minute - no hint

tratto - stretch - no hint

settimana - week - no hint

notizia - news - no hint

fratello - brother - no hint

realtà - reality - no hint

industria - industry - no hint

piacere - pleasure - no hint

maestro - teacher - no hint

personaggio - character - no hint

pomeriggio - afternoon - no hint

fianco - side - no hint

bambina - child - no hint

bellezza - beauty - no hint

domanda - question - no hint

pianta - plant - no hint

pubblico - public - no hint

sede - headquarters - no hint

affare - deal - no hint

bene - good - no hint

metà - half - no hint

papà - pope - no hint

fiume - river - no hint

lotta - fight - no hint

mercato - market - no hint

angolo - angle - no hint

compagnia - company - no hint

espressione - expression - no hint

labbro - lip - no hint

villa - villa - no hint

desiderio - desire - no hint

serie - series - no hint

visita - visit - no hint

coraggio - courage - no hint

direttore - director - no hint

esercito - army - no hint

grado - degree - no hint

padrone - master - no hint

risposta - answer - no hint

tavola - table - no hint

immagine - image - no hint

montagna - mountain - no hint

energia - energy - no hint

fede - wedding ring - no hint

pane - bread - no hint

seguito - following - no hint

estate - estate - no hint

film - film - no hint

frutto - fruit - no hint

onore - honor - no hint

pericolo - danger - no hint

scrittore - writer - no hint

collina - hill - no hint

zio - uncle - no hint

difesa - defence - no hint

metro - metro - no hint

collo - neck - no hint

cura - care - no hint

disposizione - arrangement - no hint

domenica - sunday - no hint

giovanotto - young man - no hint

poeta - poet - no hint

stagione - season - no hint

peso - weight - no hint

tono - tone - no hint

croce - cross - no hint

decisione - decision - no hint

poesia - poetry - no hint

fiducia - trust - no hint

filo - wire - no hint

folla - fucks - no hint

qualità - quality - no hint

roba - goods - no hint

conoscenza - knowledge - no hint

favore - favor - no hint

popolazione - population - no hint

strumento - tool - no hint

uso - use - no hint

vestito - dress - no hint

commercio - business - no hint

fabbrica - factory - no hint

giugno - june - no hint

giustizia - justice - no hint

avvocato - lawyer - no hint

messa - mass - no hint

orecchio - ear - no hint

sonno - sleep - no hint

congresso - congress - no hint

porto - harbor - no hint

calcio - football - no hint

fantasia - fantasy - no hint

matrimonio - marriage - no hint

medico - doctor - no hint

ospedale - hospital - no hint

pianura - flat land - no hint

tavolo - table - no hint

fame - fame - no hint

latte - milk - no hint

merito - merit - no hint

attore - actor - no hint

ricchezza - wealth - no hint

sacrificio - sacrifice - no hint

atteggiamento - attitude - no hint

concetto - concept - no hint

mestiere - craft - no hint

attesa - waiting - no hint

bagno - bathroom - no hint

foglia - leaf - no hint

istante - instant - no hint

lago - the needle - no hint

questo - this - no hint

quello - that - no hint

più - more - no hint

tutto - all - no hint

suo - his - no hint

altro - other - no hint

mio - my - no hint

quale - which - no hint

tanto - so much - no hint

grande - big - no hint

poco - little - no hint

molto - very - no hint

nostro - our - no hint

stesso - same - no hint

primo - first - no hint

loro - their - no hint

ogni - every - no hint

proprio - own - no hint

solo - only - no hint

quanto - how much - no hint

bello - beautiful - no hint

qualche - some - no hint

nuovo - new - no hint

certo - of course - no hint

vero - true - no hint

buono - good - no hint

tuo - your - no hint

nessuno - nobody - no hint

alcuno - any - no hint

italiano - italian - no hint

ultimo - last - no hint

vecchio - old - no hint

piccolo - small - no hint

troppo - too much - no hint

tale - such - no hint

giovane - young - no hint

alto - high or tall - no hint

vostro - your - no hint

diverso - different - no hint

meglio - better - no hint

lungo - long - no hint

povero - poor - no hint

maggiore - greater - no hint

mezzo - half - no hint

secondo - second - no hint

lontano - far - no hint

vicino - close - no hint

possibile - possible - no hint

caro - dear - no hint

pieno - full - no hint

nero - black - no hint

particolare - particular - no hint

bianco - white - no hint

forte - strong - no hint

politico - politic - no hint

attuale - current - no hint

latino - latino - no hint

impossibile - impossible - no hint

sereno - serene - no hint

puro - pure - no hint

normale - normal - no hint

perfetto - perfect - no hint

piano - plan - no hint

caratteristico - characteristic - no hint

russo - russian - no hint

continuo - continuous - no hint

stupido - stupid - no hint

estremo - extreme - no hint

grigio - grey - no hint

reale - real - no hint

interessante - interesting - no hint

medesimo - same - no hint

religioso - religious - no hint

ampio - broad - no hint

biondo - blond - no hint

ufficiale - official - no hint

attento - careful - no hint

enorme - enormous - no hint

sottile - thin - no hint

triste - sad - no hint

minimo - minimum - no hint

privato - private - no hint

rapido - quick - no hint

quarto - bedroom - no hint

diretto - direct - no hint

nobile - noble - no hint

parecchio - quite a lot of - no hint

pericoloso - dangerous - no hint

giallo - yellow - no hint

pazzo - crazy - no hint

sacro - sacred - no hint

comodo - comfortable - no hint

elettrico - electric - no hint

assoluto - absolute - no hint

cristiano - christian - no hint

antico - ancient - no hint

rosso - red - no hint

chiaro - clear - no hint

unico - single - no hint

sicuro - sure - no hint

importante - important - no hint

vario - varied - no hint

giusto - quite right - no hint

francese - french - no hint

vivo - alive - no hint

generale - general - no hint

ricco - rich - no hint

grosso - thick - no hint

necessario - necessary - no hint

libero - free - no hint

nazionale - national - no hint

basso - bass - no hint

semplice - simple - no hint

grave - grave - no hint

pubblico - public - no hint

comune - common - no hint

freddo - cold - no hint

economico - cheap - no hint

felice - happy - no hint

difficile - difficult - no hint

tedesco - german - no hint

breve - short - no hint

pronto - early - no hint

serio - i laughed - no hint

presente - here i&#39;m - no hint

migliore - best - no hint

facile - easy - no hint

terzo - third - no hint

caldo - hot - no hint

estero - abroad - no hint

largo - length - no hint

pricipale - main - no hint

verde - green - no hint

romano - roman - no hint

umano - human - no hint

inutile - useless - no hint

moderno - modern - no hint

numeroso - numerous - no hint

simile - similar - no hint

fresco - fresh - no hint

militare - military - no hint

americano - american - no hint

vuoto - empty - no hint

ciascuno - each - no hint

tranquillo - quiet - no hint

contento - happy - no hint

storico - historical - no hint

superiore - higher - no hint

inglese - english - no hint

fermo - stop - no hint

solito - usual - no hint

buio - dark - no hint

strano - strange - no hint

noto - known - no hint

prossimo - next one - no hint

profondo - deep - no hint

sociale - social - no hint

cattivo - bad - no hint

massimo - maximum - no hint

intero - whole - no hint

uguale - equal - no hint

bravo - bravo - no hint

brutto - gross - no hint

preciso - necessary - no hint

qualsiasi - any - no hint

improvviso - sudden - no hint

famoso - famous - no hint

straniero - foreigner - no hint

civile - civil - no hint

internazionale - international - no hint

interno - indoor - no hint

vasto - vast - no hint

segreto - secret - no hint

greco - greek - no hint

naturale - natural - no hint

sinistro - left - no hint

duro - lasted - no hint

stanco - tired out - no hint

azzurro - light blue - no hint

recente - recent - no hint

notevole - remarkable - no hint

cittadino - citizen - no hint

destro - right - no hint

europeo - european - no hint

zitto - zitto - no hint

medio - means, medium - no hint

qualunque - whatever - no hint

straordinario - extraordinary - no hint

nudo - naked - no hint

futuro - future - no hint

cattolico - catholic - no hint

capace - to be able - no hint

industriale - industrial - no hint

personale - personal - no hint

centrale - central - no hint

tecnico - technical - no hint

dolce - sweet - no hint

leggero - light - no hint

morale - moral - no hint

utile - helpful - no hint

contrario - contrary - no hint

speciale - special - no hint

peggio - worse - no hint

minore - minor - no hint

contadino - farmer - no hint

essere - to be - no hint

avere - to have - no hint

dire - say - no hint

potere - power - no hint

volere - want - no hint

sapere - know - no hint

stare - condition - no hint

dovere - must - no hint

vedere - to see - no hint

andare - to go - no hint

venire - to come - no hint

dare - give - no hint

parlare - speak - no hint

trovare - to find - no hint

sentire - feel - no hint

lasciare - to leave - no hint

prendere - to take - no hint

guardare - to watch - no hint

mettere - to put - no hint

pensare - to think - no hint

passare - to pass - no hint

credere - to believe - no hint

portare - bring - no hint

parere - opinion - no hint

tornare - return - no hint

sembrare - to seem - no hint

tenere - to keep - no hint

capire - to understand - no hint

morire - to die - no hint

chiamare - to call - no hint

conoscere - know - no hint

rimanere - stay - no hint

chiedere - to ask - no hint

cercare - search for - no hint

entrare - to come in - no hint

vivere - to live - no hint

aprire - to open - no hint

uscire - go out - no hint

ricordare - to remember - no hint

bisognare - need - no hint

cominciare - begin - no hint

rispondere - reply - no hint

aspettare - wait - no hint

riuscire - to success - no hint

chiudere - to close - no hint

finire - to end - no hint

arrivare - arrive - no hint

scrivere - to write - no hint

diventare - become - no hint

restare - to remain - no hint

seguire - follow - no hint

bastare - suffice - no hint

perdere - to lose - no hint

rendere - make - no hint

correre - to run - no hint

salvare - to save - no hint

vestire - to dress - no hint

costruire - build - no hint

camminare - to walk - no hint

ritrovare - find - no hint

durare - to last - no hint

accendere - switch on - no hint

evitare - to avoid - no hint

immaginare - to imagine - no hint

ridurre - reduce - no hint

contenere - to contain - no hint

fissare - fix - no hint

costringere - force - no hint

abbandonare - abandon - no hint

attendere - wait for - no hint

preferire - to prefer - no hint

scegliere - to choose - no hint

avvertire - warn - no hint

proporre - to propose - no hint

temere - to fear - no hint

esprimere - to express - no hint

spingere - push - no hint

salutare - to greet - no hint

udire - hear - no hint

difendere - stick up for - no hint

dirigere - direct - no hint

cantare - to sing - no hint

sorgere - to rise - no hint

assicurare - ensure - no hint

assumere - to hire - no hint

tendere - to tend - no hint

dividere - to divide - no hint

scusare - excuse - no hint

mantenere - to maintain - no hint

ritenere - consider - no hint

concludere - to conclude - no hint

saltare - jump - no hint

stabilire - to establish - no hint

appartenere - to belong - no hint

possedere - to possess - no hint

risultare - result - no hint

suonare - play - no hint

coprire - cover up - no hint

insegnare - to teach - no hint

affermare - to assert - no hint

rivelare - reveal - no hint

conservare - to preserve - no hint

risolvere - to solve - no hint

concedere - grant - no hint

limitare - to limit - no hint

abitare - live - no hint

convincere - to convince - no hint

comprare - to buy - no hint

legare - to tie - no hint

sostenere - to sustain - no hint

nascere - to be born - no hint

presentare - to introduce - no hint

trattare - to deal - no hint

piacere - pleasure - no hint

continuare - continuation - no hint

partire - start - no hint

servire - to serve - no hint

giungere - come - no hint

fermare - stop - no hint

apparire - to appear - no hint

amare - to love - no hint

esistere - to exist - no hint

intendere - intend - no hint

salire - to go up - no hint

mancare - food - no hint

ridere - to laugh - no hint

lavorare - to work - no hint

alzare - raise up - no hint

riconoscere - to recognize - no hint

sedere - sit down - no hint

leggere - to read - no hint

cadere - fall - no hint

mangiare - to eat - no hint

dormire - to sleep - no hint

raggiungere - to reach - no hint

comprendere - understand - no hint

scendere - get off - no hint

compiere - fulfill - no hint

toccare - to touch - no hint

considerare - to consider - no hint

muovere - move - no hint

stringere - tighten - no hint

mandare - send - no hint

domandare - ask - no hint

ascoltare - to listen - no hint

decidere - to decide - no hint

ricevere - receive - no hint

osservare - to observe - no hint

permettere - to allow - no hint

avvenire - take place - no hint

spiegare - explain - no hint

raccogliere - to collect - no hint

ottenere - get - no hint

offrire - to offer - no hint

mostrare - to exhibit - no hint

accompagnare - accompany - no hint

dimenticare - forget - no hint

pregare - to pray - no hint

raccontare - to tell - no hint

bere - his - no hint

ritornare - to return - no hint

cambiare - to change - no hint

dimostrare - to demonstrate - no hint

sperare - to hope - no hint

sposare - to marry - no hint

ammettere - to admit - no hint

fuggire - run away - no hint

liberare - to free - no hint

riferire - report - no hint

svegliare - to wake up - no hint

capitare - happen - no hint

posare - place - no hint

impedire - to prevent - no hint

gettare - to throw - no hint

vendere - to sell - no hint

distinguere - to distinguish - no hint

offendere - to offend - no hint

rimettere - put back - no hint

rompere - break - no hint

godere - to enjoy - no hint

imporre - to impose - no hint

significare - mean - no hint

desiderare - to desire - no hint

divertire - amuse - no hint

volgere - turn - no hint

giudicare - to judge - no hint

produrre - to produce - no hint

avvicinare - approach - no hint

diffondere - spread - no hint

ordinare - to sort - no hint

invitare - to invite - no hint

discutere - to discuss - no hint

sbagliare - make a mistake - no hint

badare - look after - no hint

tagliare - to cut - no hint

pubblicare - to publish - no hint

attaccare - attack - no hint

imparare - learn - no hint

prevedere - forecast - no hint

scappare - to escape - no hint

spegnere - switch off - no hint

annunciare - to announce - no hint

baciare - to kiss - no hint

esporre - to expose - no hint

attraversare - go across - no hint

fornire - to provide - no hint

segnare - mark - no hint

superare - overcome - no hint

rivedere - to review - no hint

allontanare - move away - no hint

ammazzare - kill - no hint

accogliere - receive - no hint

voltare - turn - no hint

preoccupare - worry - no hint

provocare - cause - no hint

riempire - to fill - no hint

partecipare - take part - no hint

piantare - plant - no hint

rientrare - re/enter - no hint

richiedere - request - no hint

nascondere - to hide - no hint

ripetere - to repeat - no hint

scoprire - to discover - no hint

preparare - prepare - no hint

scorrere - slide - no hint

rappresentare - to represent - no hint

riprendere - to resume - no hint

costituire - constitute - no hint

incontrare - meet - no hint

valere - be worth - no hint

accorgersi - notice - no hint

provare - try - no hint

formare - formation - no hint

uccidere - kill - no hint

tirare - pull - no hint

togliere - remove - no hint

notare - to notice - no hint

aggiungere - to add - no hint

succedere - happen - no hint

pagare - to pay - no hint

tentare - to attempt - no hint

accadere - to happen - no hint

creare - create - no hint

importare - import - no hint

pesare - weigh - no hint

usare - use - no hint

accettare - to accept - no hint

indicare - indicate - no hint

buttare - throw - no hint

battere - beat - no hint

interessare - to interest - no hint

sorridere - to smile - no hint

condurre - to conduct - no hint

disporre - arrange - no hint

unire - to merge - no hint

aiutare - to help - no hint

piangere - to cry - no hint

girare - turn - no hint

levare - remove - no hint

soffrire - suffer - no hint

recare - bear - no hint

riguardare - relate - no hint

rivolgere - address - no hint

tacere - keep quiet - no hint

occorrere - take - no hint

porre - to pose - no hint

vincere - to win - no hint

svolgere - carry out - no hint

studiare - to study - no hint

crescere - to grow up - no hint

divenire - become - no hint

gridare - shout - no hint

dichiarare - declare - no hint

contare - to count - no hint

giocare - play - no hint

assistere - assist - no hint

aumentare - to increase - no hint

lanciare - to launch - no hint

determinare - to determine - no hint

scherzare - joke - no hint

elevare - elevate - no hint

promettere - to promise - no hint

scomparire - to disappear - no hint

trarre - draw - no hint

distruggere - to destroy - no hint

meritare - deserve - no hint

dedicare - dedicate - no hint

iniziare - to start - no hint

sorprendere - to surprise - no hint

trasformare - to commute - no hint

confessare - to confess - no hint

arrestare - stop - no hint

ringraziare - to thank - no hint

riunire - gather - no hint

volare - to fly - no hint

fondare - to found - no hint

guidare - to drive - no hint

ferire - to hurt - no hint

opporre - to oppose - no hint

procedere - proceed - no hint

smettere - stop - no hint

consentire - allow - no hint

innamorare - fall in love - no hint

organizzare - to organize - no hint

rifiutare - to reject - no hint

riportare - to report - no hint

dipendere - to depend - no hint

provvedere - provide - no hint

trascinare - to drag - no hint

fumare - to smoke - no hint

scoppiare - burst - no hint

sognare - to dream - no hint

appoggiare - support - no hint

armare - reinforcement - no hint

celebrare - to celebrate - no hint

descrivere - to describe - no hint

resistere - resist - no hint

bruciare - burn - no hint

colpire - hit - no hint

estendere - extend - no hint

staccare - detach - no hint

affrontare - face up to - no hint

avanzare - push forward - no hint

comporre - to compose - no hint

escludere - to exclude - no hint

figurare - appear - no hint

insistere - to insist - no hint

il - the - no hint

di - of - no hint

e - is - no hint

a - a - no hint

un - a - no hint

in - in - no hint

che - that - no hint

non - not - no hint

si - and - no hint

da - gives - no hint

lo - it - no hint

per - for - no hint

con - with - no hint

ma - ma - no hint

come - come - no hint

su - its - no hint

mi - me - no hint

anche - also - no hint

o - the - no hint

io - i - no hint

se - i know - no hint

perché - why - no hint

li - at the - no hint

ci - there - no hint

ne - born - no hint

lei - lei - no hint

ancora - yet - no hint

tu - you - no hint

lui - his - no hint

senza - without - no hint

bene - good - no hint

cui - which - no hint

chi - spending - no hint

già - already - no hint

dopo - after - no hint

uno - one - no hint

noi - we - no hint

dove - where is it - no hint

qui - who - no hint

no - no - no hint

allora - then - no hint

tra - between - no hint

vi - we - no hint

ora - now - no hint

fra - from - no hint

prima - before - no hint

forse - perhaps - no hint

sì - yup - no hint

sotto - under - no hint

voi - butter - no hint

fino - up - no hint

oggi - today - no hint

quasi - almost - no hint

pure - pure - no hint

egli - he - no hint

mentre - while - no hint

contro - versus - no hint

invece - instead - no hint

esso - it - no hint

là - was - no hint

però - but - no hint

né - neither - no hint

subito - immediately - no hint

verso - towards - no hint

ciò - what - no hint

ecco - here - no hint

loro - their - no hint

essa - that - no hint

fuori - out - no hint

meno - less - no hint

adesso - now - no hint

niente - anything - no hint

cioè - that is - no hint

male - male - no hint

nulla - nothing - no hint

ah - ah - no hint

oh - oh - no hint

quindi - then - no hint

appena - as soon as - no hint

insieme - together - no hint

dunque - therefore - no hint

dentro - within - no hint

durante - during - no hint

almeno - at least - no hint

secondo - second - no hint

anzi - rather - no hint

oramai - now - no hint

oltre - beyond - no hint

intorno - around - no hint

sopra - above - no hint

dietro - behind - no hint

davanti - front - no hint

soltanto - only - no hint

infatti - indeed - no hint

qualcosa - something - no hint

spesso - often - no hint

accordo - agreement - no hint

ieri - yesterday - no hint

davvero - really - no hint

lì - there - no hint

qualcuno - someone - no hint

avanti - forward - no hint

assai - very much - no hint

presto - soon - no hint

qua - by - no hint

domani - tomorrow - no hint

circa - about - no hint

giù - down - no hint

soprattutto - mostly - no hint

nemmeno - not even - no hint

grazie - thank you - no hint

tuttavia - however - no hint

appunto - precisely - no hint

neppure - not even - no hint

eh - eh - no hint

veramente - really - no hint

tardi - late - no hint

insomma - in conclusion - no hint

presso - at - no hint

intanto - in the meantime - no hint

lungo - long - no hint

neanche - neither - no hint

piuttosto - rather - no hint

stasera - tonight - no hint

perciò - therefore - no hint

naturalmente - of course - no hint

accanto - next - no hint

eppure - but yet - no hint

eccetera - etc - no hint

finalmente - finally - no hint

infine - finally - no hint

poiché - as - no hint

comunque - in any case - no hint

dinanzi - before - no hint

abbastanza - quite - no hint

peccato - sin - no hint

certamente - of course - no hint

coloro - those - no hint

attorno - around - no hint

magari - maybe - no hint

oppure - or - no hint

inoltre - furthermore - no hint

indietro - back - no hint

addosso - on - no hint

addirittura - even - no hint

finché - as long as - no hint

perfino - even - no hint

affatto - at all - no hint

stamattina - this morning - no hint

completamente - completely - no hint

probabilmente - probably - no hint

chissà - who knows - no hint

sino - otherwise - no hint

ognuno - each one - no hint

entro - within - no hint

