canlı - ज़िंदा - no hint
sinirli - गुस्सा - no hint
kaygılı - चिंताजनक - no hint
kötü - खराब - no hint
güzel - सुंदर - no hint
en iyi - श्रेष्ठ - no hint
büyük - बड़े - no hint
acı - दर्द - no hint
sıkıcı - उबाऊ - no hint
parlak - उज्ज्वल - no hint
yoğun - सघन - no hint
sakin - मेरी - no hint
ucuz - सस्ता - no hint
temiz - स्वच्छ - no hint
bulutlu - बादल - no hint
soğuk - सर्दी - no hint
serin - ठंडा - no hint
sevimli - प्यारा - no hint
koyu - अंधेरा - no hint
lezzetli - स्वादिष्ट - no hint
farklı - भिन्न हो - no hint
zor - कठिन - no hint
kirli - गंदा - no hint
iğrenç - घिनौना - no hint
memnuniyetsiz - असंतुष्ट - no hint
erken - शीघ्र - no hint
kolay - आसान - no hint
utanmiş - शर्मिंदा - no hint
heyecanlı - जोश में आना - no hint
heyecan verici - उत्तेजित करनेवाला - no hint
pahalı - महंगा है - no hint
ünlü - ख्याति प्राप्त - no hint
uzak - दूर - no hint
yabancı - विदेश - no hint
bedava - नि: शुल्क - no hint
tok - लिया - no hint
komik - मजेदार - no hint
iyi - अच्छा न - no hint
harika - बहुत खुबस - no hint
mutlu - शुभ स - no hint
sert - कठिन - no hint
ağır - हैवी - no hint
yüksek - उच्च - no hint
sıcak - गरम - no hint
nemli - नम - no hint
aç - भूखे पेट - no hint
önemli - महत्वपूर्ण - no hint
akıllı - होशियार - no hint
ilginç - दिलचस्प - no hint
nazik - मेहरबान - no hint
büyük - बड़े - no hint
geç - विलंब से - no hint
hafıf - हफ़्फ़ - no hint
hayat dolu - जीवंत - no hint
uzun - लंबा - no hint
yüksek sesli - जोर - no hint
düşük - कम - no hint
evli - शादी हो गई - no hint
kaba - अशिष्ट - no hint
dar - लेकिन अ - no hint
yakın - पास में - no hint
kaygılı - चिंताजनक - no hint
yeni - नवीन व - no hint
iyi - अच्छा न - no hint
eski - पुराना - no hint
ağrılı - पीड़ादायक - no hint
fakir - गरीब - no hint
sessiz - शांत - no hint
yağmurlu - बरसाती - no hint
rahatlatıcı - आराम - no hint
zengin - धनी - no hint
doğru - सही - no hint
üzgün - उदास - no hint
tuzlu - नमकीन - no hint
aynı - वही - no hint
memnun - संतुष्ट - no hint
korkunç - भयानक - no hint
ciddi - गंभीर - no hint
kısa - कम - no hint
utangaç - संकोच - no hint
tek - एक - no hint
küçük - छोटा - no hint
yumuşak - मुलायम - no hint
ekşi - खट्टा - no hint
özel - विशेष - no hint
acı - दर्द - no hint
güçlü - बलवान - no hint
güneşli - धूप - no hint
emin - ज़रूर - no hint
tatlı - मिठाई - no hint
uzun - लंबा - no hint
susamış - प्यासे - no hint
yorgun - थका हुआ - no hint
doğru - सही - no hint
çirkin - कुरूप - no hint
sıcacık - गरम - no hint
zayıf - कमज़ोर - no hint
genış - चौड़ा - no hint
rüzgarlı - तूफानी - no hint
yanlıs - असत्य - no hint
genç - युवा - no hint
yetişkin - वयस्क - no hint
uçak - विमान - no hint
kol - कर्नल - no hint
bebek - बेबी - no hint
sırt - वापस - no hint
banyo - बाथरूम - no hint
yatak - बिस्तर - no hint
yatak odası - शयनकक्ष - no hint
sığır eti - भैस का मांस - no hint
bira - बीयर - no hint
bisiklet - बाइक - no hint
tekne - नाव - no hint
vücut - तन - no hint
kitap - पुस्तक - no hint
oğlan - लड़का - no hint
erkek arkadaş - प्रेमी - no hint
ekmek - रोटी - no hint
otobüs - बस - no hint
takvim - पंचांग - no hint
araba - गाड़ी - no hint
cep telefonu - चल दूरभाष - no hint
göğüs - छाती - no hint
tavuk - मुर्गी - no hint
çocuk - बच्चा - no hint
saat - पल - no hint
giysi - वस्त्र - no hint
bulut - बादल - no hint
kahve - कॉफ़ी - no hint
bilgisayar - संगणक - no hint
aşçı - बावर्ची - no hint
kredi kartı - क्रेडिट कार्ड - no hint
fincan - कप - no hint
kız - लड़की - no hint
bankamatik kartı - डेबिट कार्ड - no hint
doktor - चिकित्सक - no hint
elbise - परिधान - no hint
çalışan - काम कर रहे - no hint
mühendis - इंजीनियर - no hint
baba - दाई - no hint
parmak - उंगली - no hint
balık - मछली - no hint
yiyecek - खाना - no hint
ayak - पैर - no hint
arkadaş - मित्र - no hint
meyve - फल - no hint
kız - लड़की - no hint
kız arkadaş - प्रेमिका - no hint
kafa - सिर - no hint
helikopter - हेलीकॉप्टर - no hint
otel - होटल - no hint
saat - पल - no hint
koca - पति - no hint
buz - बर्फ - no hint
ceket - जैकेट - no hint
mutfak - रसोई - no hint
kuzu eti - मेमने का मांस - no hint
bacak - टांग - no hint
adam - एडम - no hint
yönetici - मैनेजर - no hint
dakika - मिनट - no hint
sabah - सबा - no hint
anne - ऐनी - no hint
motosiklet - मोटरसाइकिल - no hint
hemşire - नर्स - no hint
pantolon - पतलून - no hint
kurşun kalem - पेंसिल - no hint
tabak - तंबाकू - no hint
polis memuru - पुलिस अधिकारी - no hint
domuz eti - सुअर का मांस - no hint
programcı - प्रोग्रामर - no hint
yağmur - वर्षा - no hint
satis elemani - विक्रेता - no hint
tuz - नमक - no hint
saniye - दूसरा - no hint
gömlek - कमीज - no hint
ayakkabı - जूता - no hint
kar - कर - no hint
çorap - मोज़े - no hint
kanepe - सोफ़ा - no hint
erkek evlat - बेटा - no hint
mide - उपाय - no hint
mağaza - दुकान - no hint
şeker - कैंडी - no hint
güneş - रवि - no hint
taksi - टैक्सी - no hint
çay - चाय - no hint
öğretmen - अध्यापक - no hint
televizyon - टेलीविजन - no hint
bugün - आज - no hint
yarın - आने वाला कल - no hint
tren - रेल गाडी - no hint
sebze - सब्जियां - no hint
su - आईटी इस - no hint
hafta - सप्ताह - no hint
eş - पति या पत्नी - no hint
şarap - वाइन - no hint
kadın - महिला - no hint
yıl - साल - no hint
dün - बिता हुआ कल - no hint
kesinlikle - पूर्ण रूप से - no hint
tamam - ठीक है - no hint
iyi misin - तुम ठीक हो - no hint
harika - बहुत खुबस - no hint
hoşçakal - अलविदा - no hint
bay bay - मक्खी मक्खी - no hint
hesap - लेखा - no hint
tebrikler - बहुत बहुत बधाई - no hint
leziz - स्वादिष्ट - no hint
anlıyor musun - क्या आप समझे - no hint
yapma - निर्माण - no hint
lafı olmaz - मुझे कोई आपत्ति नहीं - no hint
merak etme - चिंता मत करो - no hint
afedersininz - एक्स्चुसे में - no hint
dümdüz gidin - सीधे जाओ - no hint
iyi günler - आपका दिन शुभ हो - no hint
iyi akşamlar - सुसंध्या - no hint
günaydın - शुभ प्रभात - no hint
iyi geceler - शुभ रात्रि - no hint
güle güle - खुद हाफिज - no hint
merhaba - नमस्ते - no hint
yardım edin - हाथ बटाना - no hint
bekle - रुको - no hint
nasılsın - जिंदगी कैसी चल रही है - no hint
nasıl gidebilirim - मैं कैसे जा सकता हूँ - no hint
nasılsınız - होर सुनाओ - no hint
nasılsın - जिंदगी कैसी चल रही है - no hint
nasıl - किस तरह - no hint
annen nasıl - आपकी मां कैसी हैं - no hint
ne kadar - कितना - no hint
kaç yaşındasınız - आपकी उम्र क्या है - no hint
günün nasıldı - आपका दिन कैसा बीता - no hint
hava nasıl - मौसम कैसा है - no hint
kazası - दुर्घटना - no hint
çanta - बैग - no hint
anahtar - चाभी - no hint
kaybetmek - खोने के लिए - no hint
iletişim - संपर्क करें - no hint
bilgi - जानकारी - no hint
bulunuyor - स्थित है - no hint
ihtiyac - जरुरत - no hint
aramak - खोज कर - no hint
fiş - प्लग - no hint
poşet - बैग - no hint
bundan - इस से - no hint
kimlik - ईद - no hint
kazanmak - जीत - no hint
hak etmek - लायक - no hint
tüm - सब - no hint
dikkatli - सावधान - no hint
hakkında - के बारे में - no hint
hala - फिर भी - no hint
emin - ज़रूर - no hint
yüzde - प्रतिशत - no hint
şansim - मेरा मौका - no hint
arttı - बढ़ गया है - no hint
söylediği - उन्होंने कहा - no hint
bunun için - इसके लिए - no hint
eğer - अगर - no hint
varsa - अगर वहाँ है - no hint
ilgilendirmez - यह प्रासंगिक नहीं है - no hint
bırak - छोड़ना - no hint
gergin - बेचैन - no hint
acımak - दया - no hint
gerçekten gerginim - मुझे वास्तव में घबराहट हो रही है - no hint
endişeliyim - मैं चिंतित हूँ - no hint
o acıtır - यह दुखदायक है - no hint
çok üzücü - बहुत दुख की बात है - no hint
nerdeyse vardık - लगभग हम पहुंचे - no hint
pes etme - हार नहीं माने - no hint
neredeyse yapmıştım - मैंने लगभग किया - no hint
iyi hissetmiyorum - मैं अच्छा महसूस नहीं करता - no hint
bence yapabilirsin - मुझे लगता है कि आप इसे कर सकते हैं - no hint
biliyorum - मैं जानता हूँ - no hint
hangi renk? - क्या रंग? - no hint
internete bağlanamıyorum - मैं इंटरनेट से कनेक्ट नहीं कर सकता - no hint
lütfen yazınız - कृपया लिखें - no hint
bitirdin mi? - क्या तुमने पूरा कर लिया? - no hint
çiçekler açıyor - फूल खिल रहे हैं - no hint
tokum - टोकना - no hint
nereye gidiyoruz - हम कहाँ जा रहे हैं - no hint
hesap - लेखा - no hint
bunu alıcam - मैं यह लूंगा - no hint
lütfen oturun - कृपया बैठ जाओ - no hint
neye benziyorlardı - वे किसके जैसे दिखाई दे रहे थे - no hint
şimdi gidiyorum - मैं जा रहा हूं - no hint
televizyon çalışmıyor - टेलीविजन काम नहीं करता है - no hint
sadece salı - केवल रविवार - no hint
bugün çarşamba - आज बुधवार है - no hint
neredeyse alacakaranlık - लगभग सांझ - no hint
gece yarısı - आधी रात - no hint
öğle - दोपहर - no hint
saat üç - यह तीन बजे हैं - no hint
hobilerin ne - आपके शौक क्या हैं - no hint
tebrikler - बहुत बहुत बधाई - no hint
lütfen, oturun - कृपया बैठ जाओ - no hint
içeri gel - अंदर आएं - no hint
çok düşüncelisin - आप बहुत विचारशील हैं - no hint
yapmamalıydın - आपके पास नहीं होना चाहिए - no hint
hoşgeldiniz - स्वागत हे - no hint
amerikalıyım - मैं अमेरिकी हूँ - no hint
hasta hissediyorum - मैं बीमार महसूस कर रहा हूँ - no hint
harika görünüyorsun - तुम गज़ब की लग रही हो - no hint
size bırakıyorum - यह मैं तुम पर छोड़ता हूं - no hint
sevdin mi - क्या आपको पसंद आया - no hint
harika görünüyor - अच्छा लग रहा है - no hint
geri git - वापस जाओ - no hint
öksürüğüm var - मुझे खाँसी है - no hint
ateşim var - मुझे बुखार हे - no hint
doldu bile - पहले से ही - no hint
kaç derece - कितनी डिग्री - no hint
günün nasıldı - आपका दिन कैसा बीता - no hint
herkes nerede - सब लोग कहाँ हैं - no hint
üzgünüm - माफ़ करना - no hint
merak etme - चिंता मत करो - no hint
lütfen - कृप्या - no hint
minnetkarım - मेमोरी कार्ड - no hint
teşekkür ederim - जी शुक्रिया - no hint
merhaba - नमस्ते - no hint
günaydın - शुभ प्रभात - no hint
güle güle - खुद हाफिज - no hint
iyi akşamlar - सुसंध्या - no hint
alo? - अलो? - no hint
harika - बहुत खुबस - no hint
leziz - स्वादिष्ट - no hint
severim - मुझे तो पसन्द है - no hint
sevmem - मुझे पसंद नहीं है - no hint
nasılsın - जिंदगी कैसी चल रही है - no hint
ben iyiyim - मैं ठीक हूं - no hint
saat kaç - ये वक़्त क्या है - no hint
yardım edin - हाथ बटाना - no hint
tamam - ठीक है - no hint
gerçekten mi - क्या सच में - no hint
bu nedir - क्या है - no hint
nerelisin - आप कहां से हैं - no hint
kaç yaşındasın - आपकी उम्र क्या है - no hint
nasılsın - जिंदगी कैसी चल रही है - no hint
bu zor - यह मुश्किल है - no hint
anlamadım - मैं कुछ समझ - no hint
ben değiştim - मैं बदल गया हूं - no hint
tekrar yapmayacağım - मैं इसे फिर से नहीं करूंगा - no hint
çok yakışıklısın - आप इतने सुंदर हैं - no hint
seni seviyorum - मैं आपसे प्यार करती हूँ - no hint
ben değildim - मैं नहीं - no hint
polisi ara - पुलिस को बुलाओ - no hint
şu nedir? - वह क्या है? - no hint
bu nedir? - यह क्या है? - no hint
biz kazandık - हम जीत गए - no hint
bunbu yapamam - मैं ऐसा नहीं कर सकता - no hint
sakinleş! - शांत हो जाएं! - no hint
dikkatli ol - संभल जाना - no hint
şansim arttı - मेरी किस्मत बढ़ गई है - no hint
utangaçım - मैं शर्मीला हूँ - no hint
çok utandım - मैं बहुत शर्मिंदा था - no hint
