Turkish English Dreaming Vocab

rüya görmek - dreaming - no hint
anlaşılır - lucid - no hint
rüya - dream - no hint
rüyalar - dreams - no hint
fiziksel - physical - no hint
astral - astral - no hint
uyku - sleep - no hint
bilinç - consciousness - no hint
projeksiyon - projection - no hint
üzerine - upon - no hint
farkındalık - awareness - no hint
Dünya - earth - no hint
bilinçli - conscious - no hint
uyanma - waking - no hint
uygulama - practice - no hint
deneyimler - experiences - no hint
evre - phase - no hint
gerçeklik - reality - no hint
teknikler - techniques - no hint
teknik - technique - no hint
keçe - felt - no hint
baktı - looked - no hint
görünüyordu - seemed - no hint
beyin - brain - no hint
zihinsel - mental - no hint
olumsuz - cannot - no hint
manevi - spiritual - no hint
uçak - plane - no hint
konu - subject - no hint
netlik - lucidity - no hint
ötesinde - beyond - no hint
farkında - aware - no hint
belki - perhaps - no hint
duygu - feeling - no hint
korku - fear - no hint
eller - hands - no hint
kılavuz - guide - no hint
basitçe - simply - no hint
uykuda - asleep - no hint
öğrenmek - learn - no hint
döndü - turned - no hint
bilgi - knowledge - no hint
doğa - nature - no hint
düşünceler - thoughts - no hint
ruh - spirit - no hint
ayak - feet - no hint
hayalperest - dreamer - no hint
görünmek - seem - no hint
kendisi - itself - no hint
Dikkat - attention - no hint
derin - deep - no hint
yöntem - method - no hint
genelde - usually - no hint
uyanık - awake - no hint
tamamen - completely - no hint
biliyordu - knew - no hint
seyahat - travel - no hint
iç - inner - no hint
odak - focus - no hint
Böylece - thus - no hint
Bölünmüş - split - no hint
tarafından - door - no hint
uzun - lama - no hint
şart - condition - no hint
içeride - inside - no hint
aniden - suddenly - no hint
normal - normal - no hint
garip - strange - no hint
doğal - natural - no hint
kitabın - books - no hint
aslında - indeed - no hint
Tecrübeli - experienced - no hint
bölüm - chapter - no hint
hafıza - memory - no hint
ses - sound - no hint
kabiliyet - ability - no hint
etki - effect - no hint
hareketli - moving - no hint
vizyon - vision - no hint
denenmiş - tried - no hint
ruh - soul - no hint
çaba - effort - no hint
malzeme - material - no hint
uyanmak - wake - no hint
hareket - movement - no hint
uçan - flying - no hint
hayalperestler - dreamers - no hint
duygu - sensation - no hint
sahne - stage - no hint
belirli - particular - no hint
egzersiz yapmak - exercise - no hint
hayal etmek - imagine - no hint
görünmek - appear - no hint
bireysel - individual - no hint
seyahat - journey - no hint
olur - becomes - no hint
basit - simple - no hint
tamamen - fully - no hint
bedenler - bodies - no hint
zor - difficult - no hint
uzun - longer - no hint
duyumlar - sensations - no hint
çeşitli - various - no hint
sonbahar - fall - no hint
her neyse - whatever - no hint
girişim - attempt - no hint
varoluş - existence - no hint
giriş - enter - no hint
başladı - began - no hint
başla - begin - no hint
hemen - immediately - no hint
çift - double - no hint
düşme - falling - no hint
yavaşça - slowly - no hint
ambar - hold - no hint
ses - voice - no hint
duvar - wall - no hint
nesne - object - no hint
arzu etmek - desire - no hint
görme - sight - no hint
uygulayıcı - practitioner - no hint
trans - trance - no hint
öngörülen - projected - no hint
merkez - center - no hint
yazar - author - no hint
takip et - follow - no hint
hatırlama - recall - no hint
uyanış - awakening - no hint
zemin - ground - no hint
anılar - memories - no hint
Etkinlikler - events - no hint
Evren - universe - no hint
hayatları - lives - no hint
görme - seeing - no hint
muhtemelen - likely - no hint
tamamlayınız - complete - no hint
aktivite - activity - no hint
yollar - ways - no hint
formlar - forms - no hint
yol - path - no hint
kolayca - easily - no hint
bu nedenle - therefore - no hint
devam et - continue - no hint
anlayış - understanding - no hint
inanç - belief - no hint
meydana gelmek - occur - no hint
olmak - happen - no hint
sorular - questions - no hint
çevre - environment - no hint
proje - project - no hint
kendilerini - themselves - no hint
Cevap - answer - no hint
Varlıklar - beings - no hint
yazmak - write - no hint
oluşturmak - create - no hint
adım - step - no hint
taşındı - moved - no hint
yoga - yoga - no hint
alır - takes - no hint
öğrenme - learning - no hint
Görüntüler - images - no hint
görüntü - image - no hint
çıkış - exit - no hint
titreşimler - vibrations - no hint
direkt - direct - no hint
hızlı bir şekilde - quickly - no hint
karanlık - dark - no hint
bilinçsiz - unconscious - no hint
gerekli - necessary - no hint
bilinçaltı - subconscious - no hint
olmuş - happened - no hint
nesneler - objects - no hint
farkına varmak - realize - no hint
enerjik - energetic - no hint
Ağrı - pain - no hint
planlar - planes - no hint
masa - table - no hint
yeşil - green - no hint
felç - paralysis - no hint
günlük - journal - no hint
tanıdık - familiar - no hint
hareketler - actions - no hint
kapalı - closed - no hint
dilek - wish - no hint
duyular - senses - no hint
var olmak - exist - no hint
boyunca - throughout - no hint
Diyar - realm - no hint
resim - picture - no hint
yüzey - surface - no hint
tüm - entire - no hint
uyuyor - sleeping - no hint
Not - note - no hint
insanlar - humans - no hint
temel - basic - no hint
hakikat - truth - no hint
anlam - meaning - no hint
mesafe - distance - no hint
düşünmek - consider - no hint
ilginç - interesting - no hint
durum - situation - no hint
başlangıç - beginning - no hint
kalmak - remain - no hint
hayal gücü - imagination - no hint
doğru - towards - no hint
nefes - breath - no hint
direkt olarak - directly - no hint
sesler - sounds - no hint
kesinlikle - exactly - no hint
Sonuçta - eventually - no hint
karar - decided - no hint
okuma - reading - no hint
fikirler - ideas - no hint
belirir - appears - no hint
mevcudiyet - presence - no hint
usta - master - no hint
tek başına - alone - no hint
olma - becoming - no hint
vakalar - cases - no hint
sadece - merely - no hint
ayakta - standing - no hint
ziyaret etmek - visit - no hint
daha düşük - lower - no hint
son derece - extremely - no hint
dünyalar - worlds - no hint
nefes - breathing - no hint
özel - specific - no hint
ortaya çıktı - appeared - no hint
gitti - gone - no hint
geçti - passed - no hint
seviyeleri - levels - no hint
daha büyük - greater - no hint
olur - happens - no hint
izin vermek - allow - no hint
neden oldu - caused - no hint
yalan söylemek - lying - no hint
pencere - window - no hint
yön - direction - no hint
yöntemler - methods - no hint
egzersizler - exercises - no hint
sayfa - page - no hint
en sonunda - finally - no hint
ulaştı - reached - no hint
parçalar - parts - no hint
iyileştirme - healing - no hint
zemin - floor - no hint
dokunma - touch - no hint
bacaklar - legs - no hint
meditasyon - meditation - no hint
dikkatli - carefully - no hint
oturma - sitting - no hint
altında - below - no hint
silâh - arms - no hint
durdu - stood - no hint
hız - speed - no hint
algı - perception - no hint
tarif - described - no hint
getirdi - brought - no hint
yürüdü - walked - no hint
rahatlama - relaxation - no hint
ilahi - divine - no hint
öğrendi - learned - no hint
çeşit - sort - no hint
şekil - figure - no hint
psişik - psychic - no hint
doğru - toward - no hint
gizli - occult - no hint
kordon - cord - no hint
dosya - file - no hint
keşif - exploring - no hint
fırsat - opportunity - no hint
aksi takdirde - otherwise - no hint
kimin - whose - no hint
döngü - cycle - no hint
yanlış - false - no hint
imkansız - impossible - no hint
faliyet alani, sahne - scene - no hint
Daha derine - deeper - no hint
ilmi - scientific - no hint
nihai - ultimate - no hint
anlar - moments - no hint
kendimizi - ourselves - no hint
günlük - daily - no hint
rüzgar - wind - no hint
hissediyor - feels - no hint
Miktar - amount - no hint
düşünülen - considered - no hint
keşfetmek - explore - no hint
görünüşe göre - apparently - no hint
yirmi - twenty - no hint
kesinlikle - certainly - no hint
alanlar - areas - no hint
geliştirmek - develop - no hint
açıklamak - explain - no hint
oluşur - occurs - no hint
Etkinlik - event - no hint
merak etmek - wonder - no hint
görev - task - no hint
yönler - aspects - no hint
şartlar - terms - no hint
ince - subtle - no hint
fark - difference - no hint
uyanmak - awaken - no hint
etkilemek - influence - no hint
farkına varmak - notice - no hint
Eğitim - training - no hint
başarmak - achieve - no hint
bilmek - knowing - no hint
canlı - vivid - no hint
sürece - unless - no hint
kesinlikle - absolutely - no hint
alışılmadık - unusual - no hint
Baştan sona - entirely - no hint
güçlü - powerful - no hint
yerler - places - no hint
yaklaşmak - approach - no hint
akış - flow - no hint
gerçekten - truly - no hint
kaynak - source - no hint
Paylaş - share - no hint
birincil - primary - no hint
yürümek - walk - no hint
din - religion - no hint
Bilim - science - no hint
yaşadı - lived - no hint
yazı - writing - no hint
hedef - goal - no hint
oluştu - occurred - no hint
niyet - intention - no hint
gelişmiş - developed - no hint
ileri - forward - no hint
ruhlar - spirits - no hint
hayvanlar - animals - no hint
Antik - ancient - no hint
dini - religious - no hint
Açıkça - clearly - no hint
yazılı - written - no hint
güzel - beautiful - no hint
devam etti - continued - no hint
tavır - manner - no hint
Ilgilenen - interested - no hint
kime - whom - no hint
kopya - copy - no hint
kayıt - record - no hint
büyük ölçüde - highly - no hint
başarı - success - no hint
ilişkili - related - no hint
artırmak - increase - no hint
Deney - experiment - no hint
icra etmek - perform - no hint
gerekli - needed - no hint
Yedi - seven - no hint
yüzer - floating - no hint
derinden - deeply - no hint
ağaçlar - trees - no hint
ayrılma - leaving - no hint
bilinçli olarak - consciously - no hint
gölge - shadow - no hint
korkmuş - afraid - no hint
yoksul - poor - no hint
yaratıcı - creative - no hint
pozitif - positive - no hint
ay - moon - no hint
fenomen - phenomenon - no hint
aktif - active - no hint
katı - solid - no hint
basın - press - no hint
girdi - entered - no hint
saat - hour - no hint
saniye - seconds - no hint
biraz - slightly - no hint
duygusal - emotional - no hint
tekrar et - repeat - no hint
Daha kolay - easier - no hint
yaratıldı - created - no hint
sıradan - ordinary - no hint
ulaşmak - reach - no hint
bir yerde - somewhere - no hint
derece - degree - no hint
nedenleri - causes - no hint
doğmuş - born - no hint
normalde - normally - no hint
karanlık - darkness - no hint
gerçek - actual - no hint
yürüme - walking - no hint
denemeler - attempts - no hint
konuşmak - speak - no hint
bekleme - waiting - no hint
olumsuz - negative - no hint
görüntü - imagery - no hint
düştü - fell - no hint
etkili - effective - no hint
orta - middle - no hint
geçmek - pass - no hint
amaç - purpose - no hint
teori - theory - no hint
çile - suffering - no hint
koşullar - conditions - no hint
ağaç - tree - no hint
açıldı - opened - no hint
sorun - trouble - no hint
soğuk - cold - no hint
ilerleme - progress - no hint
Rahatlayın - relax - no hint
ağır - heavy - no hint
ayakta durmak - stand - no hint
doktor - doctor - no hint
şekil - shape - no hint
projektör - projector - no hint
mavi - blue - no hint
olanlar - ones - no hint
rakamlar - figures - no hint
projeksiyon - projecting - no hint
yuvarlak - round - no hint
İletişim - contact - no hint
projeksiyonlar - projections - no hint
boyut - dimension - no hint
tanımak - recognize - no hint
niyet - intent - no hint
gerçekleştirilen - realized - no hint
durdu - stopped - no hint
cevap verdi - replied - no hint
rahat - relaxed - no hint
keşiş - monk - no hint
muhafaza - kept - no hint
dışında - except - no hint
ayrılık - separation - no hint
algılamak - perceive - no hint
gümüş - silver - no hint
projektörler - projectors - no hint
İp - rope - no hint
merkezleri - centers - no hint
sahip olacak - aura - no hint
elde etmek - obtain - no hint
uygun - appropriate - no hint
ayrılmış - reserved - no hint
ilişki - relation - no hint
örtmek - cover - no hint
kısa - brief - no hint
kabuslar - nightmares - no hint
Metin - text - no hint
türleri - types - no hint
Psikoloji - psychology - no hint
perspektif - perspective - no hint
yoğun - intense - no hint
duygular - emotions - no hint
Zevk - pleasure - no hint
cinsel - sexual - no hint
pratik - practical - no hint
toplantı - meeting - no hint
yıldızlar - stars - no hint
gelişen - developing - no hint
iletişim - communication - no hint
kenar - edge - no hint
Muazzam - vast - no hint
canlı - alive - no hint
tutma - holding - no hint
olağan - usual - no hint
açıklık - clarity - no hint
çevre - surroundings - no hint
zihinler - minds - no hint
önceki - previous - no hint
yetenekleri - abilities - no hint
büyük ölçüde - greatly - no hint
harcamak - spend - no hint
keşfetmek - discover - no hint
altında - beneath - no hint
sekiz - eight - no hint
yüz - hundred - no hint
harcandı - spent - no hint
tartışmak - discuss - no hint
detay - detail - no hint
kesinlikle - definitely - no hint
Beceriler - skills - no hint
hoş - pleasant - no hint
gösterir - shows - no hint
detaylar - details - no hint
genel olarak - generally - no hint
gereklidir - required - no hint
arzular - desires - no hint
kişilik - personality - no hint
konsept - concept - no hint
öğretmek - teach - no hint
demek - meant - no hint
konu - topic - no hint
seyretme - watching - no hint
konsantrasyon - concentration - no hint
bardak - glass - no hint
aşamalar - stages - no hint
beklemek - expect - no hint
raporlar - reports - no hint
deneyimleme - experiencing - no hint
olay - happening - no hint
Yanıtlar - answers - no hint
alışkanlık - habit - no hint
olasılık - possibility - no hint
adımlar - steps - no hint
şüphe - doubt - no hint
oluşturma - creation - no hint
özellikle - particularly - no hint
düzenli - regular - no hint
açık - obvious - no hint
ilişkili - associated - no hint
Görünüş - aspect - no hint
tepki - response - no hint
karşılaşma - encounter - no hint
tanımlamak - describe - no hint
değiştirme - changing - no hint
hisler - feelings - no hint
biraz - somewhat - no hint
kanıtlamak - prove - no hint
kabul etmek - accept - no hint
güçler - powers - no hint
sınırlı - limited - no hint
hazırlanmış - prepared - no hint
vermek - giving - no hint
aşmak - overcome - no hint
ciddi - serious - no hint
koşma - running - no hint
olağanüstü - wonderful - no hint
öğretti - taught - no hint
potansiyel - potential - no hint
öz - essence - no hint
korkular - fears - no hint
modern - modern - no hint
konular - subjects - no hint
dahil - involved - no hint
yolculuklar - journeys - no hint
yapamaz - unable - no hint
önem - importance - no hint
batı - western - no hint
yazdı - wrote - no hint
yüzyıl - century - no hint
mektup - letter - no hint
muhtemelen - possibly - no hint
görünüm - appearance - no hint
keşfetti - discovered - no hint
mükemmel - perfect - no hint
bahsedilen - mentioned - no hint
geçen - passing - no hint
keşişler - monks - no hint
odaklanmış - focused - no hint
uygulamalar - practices - no hint
önermek - suggest - no hint
fenomen - phenomena - no hint
çalışmalar - studies - no hint
tutma - keeping - no hint
her ne zaman - whenever - no hint
tavsiye - advice - no hint
sevilen - loved - no hint
kalite - quality - no hint
teşvik etmek - induce - no hint
saat - clock - no hint
başarılı - successful - no hint
psikolojik - psychological - no hint
geri dönen - returning - no hint
deneyler - experiments - no hint
daha erken - earlier - no hint
doğru - correct - no hint
değer - worth - no hint
kağıt - paper - no hint
bağ - connection - no hint
verir - gives - no hint
uyanmak - woke - no hint
oluşturma - creating - no hint
işaret - sign - no hint
Aralık - range - no hint
duyusal - sensory - no hint
çapraz - cross - no hint
daha büyük - larger - no hint
öneri - suggestion - no hint
geniş - wide - no hint
kapalı - covered - no hint
giren - entering - no hint
farkedildi - noticed - no hint
arttı - increased - no hint
inançlar - beliefs - no hint
bariz - apparent - no hint
işe yarar - useful - no hint
takip etti - followed - no hint
bilir - knows - no hint
bildirildi - reported - no hint
Düz - straight - no hint
parlak - bright - no hint
önde - ahead - no hint
aktiviteler - activities - no hint
yerleştirilmiş - placed - no hint
değişiklikler - changes - no hint
unutmak - forget - no hint
bulma - finding - no hint
İleti - message - no hint
gönderildi - sent - no hint
kaslar - muscles - no hint
desenler - patterns - no hint
anında - instantly - no hint
elementler - elements - no hint
oran - rate - no hint
üretmek - produce - no hint
önlemek - avoid - no hint
karar ver - decide - no hint
belirtilen - stated - no hint
orijinal - original - no hint
dolu - filled - no hint
sessiz - quiet - no hint
Yok - none - no hint
radyo - radio - no hint
ileri - advanced - no hint
iade - returned - no hint
aramak - seek - no hint
haftalar - weeks - no hint
gizli - secret - no hint
yaratıklar - creatures - no hint
iç - internal - no hint
eksiklik - lack - no hint
uzunluk - length - no hint
görsel - visual - no hint
yavaş - slow - no hint
dalga - wave - no hint
yardım eder - helps - no hint
dalgalar - waves - no hint
Sıklık - frequency - no hint
kaybetmek - lose - no hint
ani - sudden - no hint
inanmış - believed - no hint
karmaşık - complex - no hint
fiziksel olarak - physically - no hint
yavaş yavaş - gradually - no hint
vardiya - shift - no hint
kusursuzca - perfectly - no hint
yorgun - tired - no hint
ışıklar - lights - no hint
doğal olarak - naturally - no hint
sakin - calm - no hint
açılış - opening - no hint
Desen - pattern - no hint
at - horse - no hint
ayrı - separate - no hint
hatırladı - remembered - no hint
yatak odası - bedroom - no hint
neredeyse - nearly - no hint
Seç - choose - no hint
şiddetle - strongly - no hint
anladım - understood - no hint
Etkileri - effects - no hint
işlevi - function - no hint
kırmak - break - no hint
zorluk - difficulty - no hint
gürültü, ses - noise - no hint
hareket - motion - no hint
rahat - comfortable - no hint
bağlı - connected - no hint
parça - piece - no hint
ilişki - relationship - no hint
dakika - minute - no hint
zihinsel olarak - mentally - no hint
notlar - notes - no hint
toplamak - pick - no hint
Taşımak - carry - no hint
resimler - pictures - no hint
giriş - entry - no hint
yanında - beside - no hint
akşam - evening - no hint
hızlı - fast - no hint
var - exists - no hint
duygu - emotion - no hint
Çek - pull - no hint
başlar - begins - no hint
sormak - asking - no hint
Bölüm - section - no hint
temel - base - no hint
gözlemek - observe - no hint
değişti - changed - no hint
katma - added - no hint
benim - mine - no hint
nehir - river - no hint
nazikçe - gently - no hint
parmaklar - fingers - no hint
titreşim - vibration - no hint
tapınak şakak .. mabet - temple - no hint
varlıklar - entities - no hint
açıkladı - explained - no hint
gücü - strength - no hint
yoğunlaşmak - concentrate - no hint
kan - blood - no hint
hayvan - animal - no hint
duvarlar - walls - no hint
tıbbi - medical - no hint
arama - search - no hint
şey - stuff - no hint
Bilinmeyen - unknown - no hint
teslim almak - receive - no hint
semboller - symbols - no hint
sürdürmek - maintain - no hint
doğum - birth - no hint
hedef - target - no hint
sık sık - frequently - no hint
uçuş - flight - no hint
bir şekilde - somehow - no hint
enerjiler - energies - no hint
gemi - ship - no hint
sistemleri - systems - no hint
sandalye - chair - no hint
sembol - symbol - no hint
basınç - pressure - no hint
dönme - turning - no hint
ayna - mirror - no hint
taşınan - carried - no hint
sağlamak - provide - no hint
çalıştı - worked - no hint
varlık - entity - no hint
bulutlar - clouds - no hint
Barış - peace - no hint
Alınan - received - no hint
dağ - mountain - no hint
yapı - structure - no hint
söylüyorum - telling - no hint
gelenek - tradition - no hint
tamamen - totally - no hint
dolaylı - indirect - no hint
cennet - heaven - no hint
taş - stone - no hint
göğüs - chest - no hint
saf - pure - no hint
yükselmek - rise - no hint
Kaya - rock - no hint
ayak - foot - no hint
mil - miles - no hint
öğretmen - teacher - no hint
inanılmaz - amazing - no hint
boyutlu - dimensional - no hint
altın - golden - no hint
görselleştirme - visualization - no hint
izlenim - impression - no hint
kutsal - sacred - no hint
bin - thousand - no hint
boyun - neck - no hint
binlerce - thousands - no hint
inanç - faith - no hint
kötü - evil - no hint
ileri - forth - no hint
görselleştirmek - visualize - no hint
gül - rose - no hint
çekti - pulled - no hint
algılanan - perceived - no hint
örnek - instance - no hint
hastane - hospital - no hint
yer - location - no hint
renkler - colors - no hint
renk - color - no hint
saç - hair - no hint
hayalet - phantom - no hint
bölge - zone - no hint
et - flesh - no hint
Sessizlik - silence - no hint
Ilık, hafif sıcak - warm - no hint
mağara - cave - no hint
oldukça - fairly - no hint
Giriş - entrance - no hint
kediler - cats - no hint
saklanmış - stored - no hint
kayıt - recording - no hint
önceki - prior - no hint
iddialar - claims - no hint
yayınlanan - published - no hint
sonraki - subsequent - no hint
cesaret - courage - no hint
içerik - contents - no hint
gölgeler - shadows - no hint
şafak - dawn - no hint
aziz - saint - no hint
dolgu - filling - no hint
manzara - landscape - no hint
halüsinasyonlar - hallucinations - no hint
uyanışlar - awakenings - no hint
sadece - bare - no hint
test yapmak - testing - no hint
burun - nose - no hint
testler - tests - no hint
indüksiyon - induction - no hint
hafif - mild - no hint
beklenti - expectation - no hint
ortak - partner - no hint
artan - increasing - no hint
sürdürme - maintaining - no hint
durumlar - situations - no hint
şok - shock - no hint
kontrol - controlling - no hint
büyü - magic - no hint
kapılar - doors - no hint
gerçekler - realities - no hint
yaratıcılık - creativity - no hint
yalanlar - lies - no hint
tekne - boat - no hint
hazırlık - preparation - no hint
Meraklı - curious - no hint
sürekli - constantly - no hint
gizem - mystery - no hint
kaldırdı - lifted - no hint
yapraklar - leaves - no hint
cilt - skin - no hint
rutin - routine - no hint
nadir - rare - no hint
koymak - putting - no hint
kenara - aside - no hint
kısaca - briefly - no hint
spektrum - spectrum - no hint
kendileri - selves - no hint
keskin - sharp - no hint
önemli - considerable - no hint
yaygın olarak - commonly - no hint
görünüşte - seemingly - no hint
gözlem - observing - no hint
muayene etmek - examine - no hint
pasif - passive - no hint
okyanus - ocean - no hint
keşif - exploration - no hint
keşif - discovery - no hint
İken - whilst - no hint
tuhaf - peculiar - no hint
ortalama - average - no hint
süresi - duration - no hint
inanılmaz - incredible - no hint
gezegen - planet - no hint
çoğunluk - majority - no hint
gerek - require - no hint
yemek yiyor - eating - no hint
eylemler - acts - no hint
öğretim - teaching - no hint
sonsuz - endless - no hint
televizyon - television - no hint
sokaklar - streets - no hint
tutar - holds - no hint
fikir - opinion - no hint
bedensel - bodily - no hint
atık - waste - no hint
geliştirmek - improve - no hint
Türler - species - no hint
cennet - haven - no hint
işleyen - functioning - no hint
endişeli - concerned - no hint
sağlıklı - healthy - no hint
İddia - claim - no hint
içerik - content - no hint
analiz - analysis - no hint
damak zevki - taste - no hint
tercih - choice - no hint
aktif olarak - actively - no hint
mutlak - absolute - no hint
güzellik - beauty - no hint
Önceden - previously - no hint
dost - fellow - no hint
farklılıklar - differences - no hint
temsil etmek - represent - no hint
mutfak - kitchen - no hint
aksine - unlike - no hint
öznel - subjective - no hint
özdeş - identical - no hint
tartışıldı - discussed - no hint
beyinler - brains - no hint
sonuç - conclusion - no hint
kritik - critical - no hint
oluşturulmuş - generated - no hint
eşlik eden - accompanied - no hint
seyrek - rarely - no hint
zorlukla - hardly - no hint
teşebbüs - attempting - no hint
yükseltmek - raise - no hint
fantezi - fantasy - no hint
kavramlar - concepts - no hint
gerçekçi - realistic - no hint
tamamen - utterly - no hint
beklenen - expected - no hint
hızlı - rapid - no hint
hareketler - movements - no hint
bazen - occasionally - no hint
cevap vermek - respond - no hint
terör - terror - no hint
tepkiler - responses - no hint
hiçbiri - neither - no hint
farklı - distinct - no hint
Çeşitlilik - variety - no hint
kaldırıldı - removed - no hint
kelimenin tam anlamıyla - literally - no hint
yoğunluk - intensity - no hint
uzak - distant - no hint
türler - kinds - no hint
derin - profound - no hint
ağırlık - weight - no hint
benzersiz - unique - no hint
büyülü - magical - no hint
memnun - satisfied - no hint
kanıtlanmış - proved - no hint
sürpriz - surprise - no hint
üstüne - onto - no hint
hemen - immediate - no hint
zorluklar - difficulties - no hint
gerçekleştirilen - performed - no hint
saygı - respect - no hint
detaylı - detailed - no hint
acı çekmek - suffer - no hint
mekanizma - mechanism - no hint
tutmak - catch - no hint
otuz - thirty - no hint
eşit - equally - no hint
çocukluk - childhood - no hint
teklif - offer - no hint
beceri - skill - no hint
uygulayıcılar - practitioners - no hint
içgörü - insight - no hint
Tehlike - danger - no hint
oluşturulan - formed - no hint
özel - private - no hint
yarış - race - no hint
faktör - factor - no hint
süreçler - processes - no hint
adres - address - no hint
amaç - objective - no hint
Gerçekler - facts - no hint
çevreleyen - surrounding - no hint
yazar - writer - no hint
hedef - destination - no hint
asansör - lift - no hint
tarih - date - no hint
içerir - contains - no hint
teşebbüs - attempted - no hint
konular - topics - no hint
derinlik - depth - no hint
ömür - lifetime - no hint
tercih etmek - prefer - no hint
taze - fresh - no hint
kaynaklar - sources - no hint
tasarlanmış - designed - no hint
referans - reference - no hint
mantıklı - logical - no hint
yardım ediyor - helping - no hint
kurulmuş - established - no hint
evrim - evolution - no hint
inşa edilmiş - built - no hint
akıllı - intelligent - no hint
araçlar - tools - no hint
iletişim kurmak - communicate - no hint
kültür - culture - no hint
gizemli - mysterious - no hint
sesler - voices - no hint
insanlık - humanity - no hint
yaşlar - ages - no hint
fırsat - occasion - no hint
doğal - spontaneous - no hint
tanrılar - gods - no hint
önemli - significant - no hint
rehberlik - guidance - no hint
kaydedildi - recorded - no hint
kaldı - remained - no hint
son günlerde - recently - no hint
gizli - hidden - no hint
son - recent - no hint
açıklama - description - no hint
dördüncü - fourth - no hint
rahip - priest - no hint
merhum - deceased - no hint
ziyaret - visited - no hint
dikkate değer - remarkable - no hint
gösterilen - shown - no hint
kutsal - holy - no hint
karakterler - characters - no hint
karşısında - opposite - no hint
düzenli olarak - regularly - no hint
sağlanan - provided - no hint
başarmak - achieving - no hint
okuyucu - reader - no hint
değer - value - no hint
amaçlanan - intended - no hint
uyarmak - alert - no hint
Başlangıç - starting - no hint
iyice - thoroughly - no hint
arayan - seeking - no hint
popüler - popular - no hint
Doğu - east - no hint
Çin - china - no hint
zeka - intelligence - no hint
yönetilen - managed - no hint
ilgili - regarding - no hint
geceler - nights - no hint
kayıtları - records - no hint
on beş - fifteen - no hint
merak - curiosity - no hint
ne yazık ki - unfortunately - no hint
başarısız oldu - failed - no hint
tanınmış - famous - no hint
yorumlama - interpretation - no hint
talimatlar - directions - no hint
yakından - closely - no hint
Önerir - suggests - no hint
it - push - no hint
limitler - limits - no hint
yalnızca - purely - no hint
çift - couple - no hint
bağlantı - association - no hint
izin verildi - allowed - no hint
tetiklemek - trigger - no hint
indüklenmiş - induced - no hint
gezi - trip - no hint
uyudu - slept - no hint
dağlar - mountains - no hint
versiyon - version - no hint
araştırmacılar - researchers - no hint
korkunç - terrible - no hint
yansıma - reflection - no hint
temel - basis - no hint
yetenekli - capable - no hint
doğru - accurate - no hint
getirmek - bringing - no hint
iki defa - twice - no hint
geçiş - transition - no hint
tanımlar - describes - no hint
not alınmış - noted - no hint
belirtmek - indicate - no hint
zevk almak - enjoy - no hint
önemli - matters - no hint
kağıtlar - papers - no hint
değişmiş - altered - no hint
yükselen - raising - no hint
kalıntılar - remains - no hint
durumlar - occasions - no hint
tren - train - no hint
kendini - herself - no hint
evler - houses - no hint
taşlar - stones - no hint
yanlar - sides - no hint
doğru şekilde - correctly - no hint
çözüm - solution - no hint
Bitti - ended - no hint
setleri - sets - no hint
ayrı - apart - no hint
eksik - missing - no hint
belirlenen - determined - no hint
Giriş - access - no hint
makine - machine - no hint
kayıt etmek - save - no hint
dikkatli - careful - no hint
bağlam - context - no hint
Kahverengi - brown - no hint
döner - turns - no hint
açı - angle - no hint
derece - degrees - no hint
özellikleri - features - no hint
yanılsama - illusion - no hint
teşvik - inducing - no hint
gözlem - observation - no hint
oyunculuk - acting - no hint
Enstitü - institute - no hint
öneriler - suggestions - no hint
göndermek - send - no hint
sinyaller - signals - no hint
Bilim insanları - scientists - no hint
nedenleri - reasons - no hint
çekme - pulling - no hint
serbest bırakmak - release - no hint
Anma - mention - no hint
küre - sphere - no hint
ilave - addition - no hint
sevk - referred - no hint
merkezi - central - no hint
kullanır - uses - no hint
devam ediyor - continues - no hint
öğretiler - teachings - no hint
Şahsen - personally - no hint
üretilmiş - produced - no hint
bilgisayar - computer - no hint
tahmin - guess - no hint
karşılaştırıldığında - compared - no hint
sinyal - signal - no hint
hakiki - genuine - no hint
kabul edilmiş - accepted - no hint
meydana gelen - occurring - no hint
kanıt - proof - no hint
kolaylaştırmak - ease - no hint
sunulan - offered - no hint
izin vermek - allowing - no hint
ekstra - extra - no hint
gözle görülür - visible - no hint
değiştirmek - switch - no hint
Hanım - lady - no hint
top - ball - no hint
kısaca - shortly - no hint
kapamak - shut - no hint
En büyük - greatest - no hint
solar - solar - no hint
uyarılmış - excited - no hint
giyme - wearing - no hint
manzara - scenery - no hint
içerilen - contained - no hint
koşullar - circumstances - no hint
örnekler - examples - no hint
cihaz - device - no hint
komut - command - no hint
elektriksel - electrical - no hint
güçsüz - weak - no hint
Daha güçlü - stronger - no hint
alarm - alarm - no hint
konuşma - conversation - no hint
özgürlük - freedom - no hint
başarılı olmak - succeed - no hint
çizgiler - lines - no hint
Katılıyorum - agree - no hint
önemli - essential - no hint
uygulamak - apply - no hint
bağımsız - independent - no hint
geçersiz - void - no hint
oturma yeri - seat - no hint
Kocaman - huge - no hint
faydalar - benefits - no hint
fizik - physics - no hint
grupları - groups - no hint
uygulamalı - applied - no hint
yardım etti - helped - no hint
önermek - recommend - no hint
temeller - basics - no hint
ayı - bear - no hint
hatırlama - remembering - no hint
büyüyen - growing - no hint
hayati - vital - no hint
krallıklar - realms - no hint
döngüleri - cycles - no hint
stres - stress - no hint
amaçlar - purposes - no hint
bakış açısı - viewpoint - no hint
kırık - broken - no hint
özellikleri - characteristics - no hint
Nispeten - relatively - no hint
Manuel - manual - no hint
ilaç - medicine - no hint
bilinç bulanıklığı, konfüzyon - confusion - no hint
daha eski - older - no hint
sürüklenme - drift - no hint
dış - external - no hint
başlar - starts - no hint
takip eder - follows - no hint
fonksiyonlar - functions - no hint
Şaşkın - confused - no hint
gaz - gaze - no hint
kör - blind - no hint
zorunlu olarak - necessarily - no hint
karşılık gelen - corresponding - no hint
dayanma - resting - no hint
sıra - sequence - no hint
tam - exact - no hint
dönemler - periods - no hint
artışlar - increases - no hint
unutulmuş - forgotten - no hint
Çubuk - stick - no hint
sonraki - latter - no hint
başvurmak - refer - no hint
isimler - names - no hint
element - element - no hint
baygın - faint - no hint
tünel - tunnel - no hint
sahneler - scenes - no hint
hızla - rapidly - no hint
Bakmak - tend - no hint
inşa etmek - build - no hint
gözlemci - observer - no hint
gürültülü - loud - no hint
sesler - noises - no hint
yüzük - ring - no hint
faktörler - factors - no hint
kar - snow - no hint
alışkın - accustomed - no hint
kasa - safe - no hint
saldırı - attack - no hint
erkek - male - no hint
kadın - female - no hint
performans - performing - no hint
panik - panic - no hint
kural - rule - no hint
inç - inches - no hint
beklentiler - expectations - no hint
olanaklar - possibilities - no hint
şans - chances - no hint
işaretler - signs - no hint
kâbus - nightmare - no hint
hoş olmayan - unpleasant - no hint
içerir - contain - no hint
ay - month - no hint
bilgelik - wisdom - no hint
düşme - falls - no hint
prosedür - procedure - no hint
izin verir - allows - no hint
lider - leading - no hint
herhangi bir yer - anywhere - no hint
öğeler - items - no hint
ders - lesson - no hint
koştu - rushed - no hint
etkiler - influences - no hint
arka fon - background - no hint
sıkıca - firmly - no hint
yayılmış - spread - no hint
bağlı - depending - no hint
açıklama - explanation - no hint
alışkanlıklar - habits - no hint
bireyler - individuals - no hint
hareketler - moves - no hint
ulaşma - reaching - no hint
denge - balance - no hint
işletme - operating - no hint
yeterli - sufficient - no hint
getiriyor - brings - no hint
hile - trick - no hint
prensip - principle - no hint
Talimatlar - instructions - no hint
elde edildi - achieved - no hint
ayar - setting - no hint
başka yerde - elsewhere - no hint
sınırlamalar - limitations - no hint
zorunlu - forced - no hint
ticaret - dealing - no hint
hafif - slight - no hint
acele - rush - no hint
uyarım - stimulation - no hint
kayıp - loss - no hint
Sigara içmek - smoke - no hint
Her gün - everyday - no hint
başarısız - fail - no hint
İstenen - desired - no hint
ikincil - secondary - no hint
yarar - benefit - no hint
düşmüş - fallen - no hint
yer - spot - no hint
ideal - ideal - no hint
başarıyla - successfully - no hint
balık - fish - no hint
sağlam - firm - no hint
akraba - relative - no hint
hatırlattı - reminded - no hint
kısmen - partially - no hint
çabalar - efforts - no hint
boş - empty - no hint
mücadele etmek - struggle - no hint
sabit - constant - no hint
servis - serve - no hint
büyüme - growth - no hint
mağaza - store - no hint
uyandırmak - awoke - no hint
altın - gold - no hint
devam ediyor - continuing - no hint
tartışma - discussion - no hint
faydalı - helpful - no hint
sabit - fixed - no hint
rota - route - no hint
solmak - fade - no hint
yol açar - leads - no hint
hatırlatmak - remind - no hint
daha yakın - closer - no hint
itti - pushed - no hint
model - model - no hint
avantaj - advantage - no hint
ekran - screen - no hint
ekli - attached - no hint
açıkça - obviously - no hint
kararlı - stable - no hint
sorunlar - issues - no hint
kurallar - rules - no hint
kanunlar - laws - no hint
Yerçekimi - gravity - no hint
aşırı - extreme - no hint
öğleden sonra - afternoon - no hint
Miktar - count - no hint
şaşırmış - surprised - no hint
tipik - typical - no hint
Bahçe - garden - no hint
yakınlarda - nearby - no hint
kuşlar - birds - no hint
dövmek - beat - no hint
dersler - lessons - no hint
ifade - phrase - no hint
sıkışmış - stuck - no hint
dokundu - touched - no hint
evrensel - universal - no hint
büyümek - grow - no hint
hikayeler - stories - no hint
peri - fairy - no hint
sahip olmak - possess - no hint
geçit - passage - no hint
köprü - bridge - no hint
bağlı olmak - depends - no hint
endişelenmek - worry - no hint
bariyer - barrier - no hint
eğitimli - trained - no hint
yükseltilmiş - raised - no hint
uygun şekilde - properly - no hint
her yerde - everywhere - no hint
gösteren - showing - no hint
varsaymak - assume - no hint
ciddi anlamda - seriously - no hint
incelendi - examined - no hint
uygun - suitable - no hint
giyinmek - wear - no hint
kart - card - no hint
erkek kardeş - brother - no hint
yukarı - upwards - no hint
istekli - willing - no hint
bilge - wise - no hint
güven - confidence - no hint
tehlikeli - dangerous - no hint
Öz - abstract - no hint
sayılar - numbers - no hint
akan - flowing - no hint
taşıma - carrying - no hint
odaklanma - focusing - no hint
fiziksel olmayan - nonphysical - no hint
nefes almak - breathe - no hint
hayali - imaginary - no hint
gerektirir - requires - no hint
hızlı - quick - no hint
ortaya çıkmak - arise - no hint
önerildi - suggested - no hint
neden olan - causing - no hint
gözlemlendi - observed - no hint
atlama - jump - no hint
güven - trust - no hint
yansıtmak - reflect - no hint
Daha hızlı - faster - no hint
namaz - prayer - no hint
Çare - cure - no hint
görevler - tasks - no hint
kapsam - extent - no hint
meditasyon yapmak - meditate - no hint
seçilmiş - chosen - no hint
ilk - initial - no hint
adet - pieces - no hint
to you - size - no hint
prensipler - principles - no hint
vahşi - wild - no hint
kendiliğinden - spontaneously - no hint
konuşuyorum - speaking - no hint
heyecan - excitement - no hint
çizmek - draw - no hint
dokunma - touching - no hint
arama - calling - no hint
ders çalışıyor - studying - no hint
işaretlendi - pointed - no hint
madde - substance - no hint
en yüksek - highest - no hint
İçmek - drink - no hint
etkilemek - affect - no hint
değerli - valuable - no hint
uygun - proper - no hint
eşzamanlı - simultaneously - no hint
açıkça - lucidly - no hint
köşe - corner - no hint
gösterdi - showed - no hint
gösterir - indicates - no hint
çatı - roof - no hint
Edebiyat - literature - no hint
Felsefe - philosophy - no hint
kesinlikle - surely - no hint
yemek - meal - no hint
Tereyağı - butter - no hint
zarar - harm - no hint
organlar - organs - no hint
orta - medium - no hint
uygulama - application - no hint
kesin - definite - no hint
uyanmış - awakened - no hint
aramalar - calls - no hint
kazanç - gain - no hint
cevapladı - answered - no hint
Çiçekler - flowers - no hint
atladı - jumped - no hint
alev - flame - no hint
kaçış - escape - no hint
konfor - comfort - no hint
ister - wants - no hint
göl - lake - no hint
laboratuar - laboratory - no hint
ekspres - express - no hint
sessiz - silent - no hint
yerleşik - settled - no hint
biter - ends - no hint
bitmiş - finished - no hint
işitme - hearing - no hint
düz - flat - no hint
hayal - imagined - no hint
parmak - finger - no hint
saygı - regard - no hint
tekrarlanan - repeated - no hint
Daha - mere - no hint
star - star - no hint
düşürmek - drop - no hint
hastalık - illness - no hint
tedavi - treatment - no hint
oluşturur - creates - no hint
kaybetmek - losing - no hint
disiplin - discipline - no hint
sakinler - inhabitants - no hint
Beyan - statement - no hint
meşgul - busy - no hint
istasyon - station - no hint
ağız - mouth - no hint
canını yakmak - hurt - no hint
karakter - character - no hint
yakalandı - caught - no hint
anında - instant - no hint
kapasite - capacity - no hint
boyutları - dimensions - no hint
mevcut - existing - no hint
milyonlar - millions - no hint
ruh - psyche - no hint
neyse - anyway - no hint
istek - request - no hint
çizilmiş - drawn - no hint
algılar - perceptions - no hint
belirgin - manifest - no hint
karşı karşıya - facing - no hint
Giyim - clothing - no hint
izledi - watched - no hint
daire - circle - no hint
düştü - dropped - no hint
eğirme - spinning - no hint
solmuş - faded - no hint
kulaklar - ears - no hint
büyüdü - grew - no hint
siyahlık - blackness - no hint
yüzyıllar - centuries - no hint
daha da kötüsü - worse - no hint
alt - bottom - no hint
ince - thin - no hint
merak ediyor - wondering - no hint
sayfaları - pages - no hint
şarj etmek - charge - no hint
bulur - finds - no hint
kendini - oneself - no hint
yansıyan - reflected - no hint
mutluluk - happiness - no hint
tavır - attitude - no hint
elektrik - electricity - no hint
telefon - telephone - no hint
dış - outer - no hint
elektrik - electric - no hint
dinleme - listening - no hint
koku - smell - no hint
etkilenmiş - affected - no hint
kazanılmış - gained - no hint
yapılar - structures - no hint
bölüm - episode - no hint
etkinleştirme - enable - no hint
rulo - roll - no hint
kitle - mass - no hint
yaklaştı - approached - no hint
konuşma - speech - no hint
kaygı - anxiety - no hint
Tırmanmak - climbing - no hint
grup - band - no hint
bestelenmiş - composed - no hint
içerir - involves - no hint
kristal - crystal - no hint
mistik - mystical - no hint
varsaymak - suppose - no hint
kütüphane - library - no hint
park - park - no hint
ifade - expression - no hint
geleneksel - traditional - no hint
dünyevi - earthly - no hint
melekler - angels - no hint
delik - hole - no hint
belirlemek - identify - no hint
merak - wondered - no hint
alanlar - fields - no hint
Görüntüleme - views - no hint
geçici - temporary - no hint
dinler - religions - no hint
görünmez - invisible - no hint
Akış - stream - no hint
nazik - gentle - no hint
ulaşmak - attain - no hint
gelenekler - traditions - no hint
boğaz - throat - no hint
mide - stomach - no hint
okudu - studied - no hint
mesajlar - messages - no hint
telepati - telepathy - no hint
engin - immense - no hint
temelde - basically - no hint
yuvarlanma - rolling - no hint
sürücü - drive - no hint
yükselen - rising - no hint
toz - dust - no hint
anlatır - tells - no hint
salon - hall - no hint
kontrollü - controlled - no hint
ruhlar - souls - no hint
Giriş - introduction - no hint
Tepe - hill - no hint
kapı - gate - no hint
en çok - lamas - no hint
asılı - hanging - no hint
tuhaf - weird - no hint
Süper - super - no hint
farkına varma - realizing - no hint
hipnoz - hypnosis - no hint
teoriler - theories - no hint
