seminer - seminar - 
okyanus - ocean - no hint
garantili - guaranteed - 
dolar - dollar - 
derece - degree - 
dinle - listen - no hint
tren - train railway - 
koloni - colony - no hint
oksijen - oxygen - 
olsun - get - no hint
hızlı - fast - no hint
pozitif - positive - 
iyilik - favor - no hint
süreç - process - no hint
çocuk - child - no hint
darbe - blow - no hint
koymak - put - no hint
antibiyotik - antibiotic - aunty be oh teek
büyük - big - no hint
molekül - molecule - 
uzun - long - no hint
ben kötü bir ruh hali içindeyim - i am in a bad mood - no hint
tohum - seed - no hint
büyük bir şey değil - its no big deal - no hint
bu zor - its difficult - no hint
harita - map - no hint
düzlem - plane - no hint
denemek - try - no hint
onun söylediği kadar iyi değil - its not as good as he says - no hint
tekne - boat - you should take (a) ne(t) on the boat
tüm - all - no hint
at - at - no hint
burada - here - no hint
ada - island - no hint
büyük - great - no hint
dil - language - no hint
onur - honour - 
ince - fine - no hint
çift - double - no hint
general - general in the army - 
dijital - digital - 
almak - to buy - you buy all the stuff
iş için buradayım - i am here on business - no hint
yumuşak - your cow moo is shocked to discover it is the softest cow in the world - 
düşünmek - consider - no hint
buz - ice - no hint
göndermek - send - no hint
akşam yoğun yağış olacak - there will be heavy rain in the evening - no hint
yıldız - star - no hint
biyoloji - biology - 
şişman - fat - no hint
doktor - doctor - 
ana - main - no hint
kadın - woman - a woman is kuttin in line
dükkan - shop - no hint
trafik - traffic - 
önermek - suggest - no hint
fiş alabilir miyim lütfen - can i have a receipt please - no hint
kart - card - 
alo - hello when answering the phone - 
çocuk - children - no hint
robot - robot - 
sevinç - joy - no hint
el - hand - the letter l is written on your hand
kız - daughter - she is your daughter 'cuz she is so little
hangi renk - what color is it - no hint
birlikte - together - no hint
gri - grey - 
yazmak - write - no hint
öğretmen - teacher - the teacher says it is all right man
yangın - fire - no hint
kıyı - shore - no hint
formül - formula - this formula is only for mules
aşk - love - no hint
meyve - fruit - no hint
operatör - operator of a machine a business - 
gece - night - no hint
periyot - period - 
karbonhidrat - carbohydrate - 
iyi - nice - it is good to be nice
tokum - i am full - no hint
kimya - chemistry - 
tuttu - kept - no hint
depozito yatırmak istiyorum - id like to make a deposit - no hint
hizmet - serve - no hint
enerjik - energetic - 
sevgili - dear - no hint
çok güzel bir gün - its a beautiful day - no hint
herhangi - any - no hint
yelken - sail - no hint
nerelisin - where are you from - no hint
bir hesap açtırmak istiyorum - id like to open an account - no hint
sert - hard - no hint
çiftlik - farm - no hint
telefon - telephone - 
bu ne kadar - how much is it - no hint
iş - work - no hint
zengin - rich - no hint
ölmek - die - no hint
maske - mask - 
dağ - mount - no hint
doktor - doctor - no hint
arama - search - no hint
atletik - athletic - 
bir kez daha lütfen - once again please - no hint
sağ - right - no hint
kesir - fraction - no hint
yiyecek - food - similar to yemek, but with a jek ending like you eject food from a plane
olağan - usual - no hint
güvenli - safe - no hint
hukuk - law - no hint
sistem - system - 
bisiklet - bicycle - 
temiz - clean - no hint
katolik - catholic - 
yanmak - burn - no hint
ayrı - separate - no hint
sebze - vegetable - just vegetables in subs, ye!
yendi - beat - no hint
öyle yani - i mean this this is what happened - just like böyle yani, you tell someone what happened, a boy lay on ya knee
o - it - no hint
güçlü - strong - no hint
kök - root - no hint
taksi - taxi - 
ceket - jacket - very similar
geri - back - no hint
cevap - reply - no hint
indeks - index - 
bebek - baby - no hint
kopya - copy - no hint
burada ne yapıyorsun - what are you doing here - no hint
hakkında - about - no hint
voleybol - volleyball - 
kedi - cat - no hint
kullanım - use - no hint
patates - potato - 
şu nedir - what is that - no hint
büyük - grand - no hint
güzel - pretty - no hint
liberal - liberal - 
oluşturmak - create - no hint
boya - paint - no hint
kural - rule - no hint
onun hakkında hala düşünüyorum - i am still thinking about that - no hint
bar - bar place to drink in - 
tiyatro - theatre to see plays - 
ürün - product - no hint
bilmek - to know - 
sorun - trouble - no hint
inanıyorum - believe - no hint
baş ağrım var - i have a headache - no hint
savaş - war - no hint
düşük - low - no hint
koridor - corridor - 
rol - role - 
zengin - rich - those rich people, zey gain lots of stuff.
orijinal - original not a copy new - 
daire - circle - no hint
sembol - symbol - 
bulundu - found - no hint
bravo - bravo - 
komedi - comedy - 
otobiyografi - autobiography - 
kadar - far - no hint
cevap - answer - no hint
yeni - new - ya nee(d) new stuff all the time
dilek - wish - no hint
bu nedir - what is this - no hint
konsept - concept - 
sıcak - hot - no hint
mayın - mine - no hint
eşit - equate - no hint
fikir - idea - no hint
kar - snow - no hint
versiyon - version - 
promosyon - promotion the activity of advertising - 
daha az - less - no hint
kanser - cancer - 
milyon - million - no hint
özel - special - no hint
yürümek - walk - no hint
plan - plan - 
hipotez - hypothesis - 
kapı - door - no hint
özellikle - particular - no hint
bacak - leg - no hint
ders - course - no hint
incir - fig - no hint
hafta - week - you hafta wait a week to see someone
desen - pattern - no hint
bulutlu - cloudy - it is cloudy, but we can still loot lou
buğün nereye gittin - where did you go today - no hint
gürültü - noise - no hint
fakülte - faculty of a university - 
streç - stretch - no hint
can - can - no hint
gibi - like - no hint
iyi - good - no hint
parmak - finger - no hint
ev - home - no hint
tekrar - again - no hint
tatile mi gidiyorsun - are you going on vacation - no hint
zor - difficult - zoro does difficult things
yetenekli - able - no hint
enfeksiyon - infection - 
gül - rose - no hint
mümkün - possible - no hint
park etmek - to park vehicle - 
arama yapabilir miyim - can i make a call - no hint
yok - does - no hint
maç - match a sports event - 
organize - organized - 
ne - nor - no hint
kemik - bone - no hint
arasında - among - no hint
alt - bottom - no hint
mayis - may - no hint
lazer - laser - 
turist - tourist - 
hareket - motion - no hint
iz - track - no hint
çirkin - ugly - you cheer for ken because he has finally come out as being ugly
kahvaltı saat kaçta - what time is breakfast - no hint
sosyal - social - 
görünmek - to seem - it seems like the un sees(görmek) everything
lira - lira - 
panel - panel - 
ceket - coat - no hint
parlaklık - shine - no hint
kız - girl - your cousin is a girl
erkekler - men - no hint
satır - row - no hint
biz kazandık - we won - from kazanmak, if you win you get a new cousin
o çok şaşırdı - he was surprised - you are surprised and someone hushes you, shush, and says someone will hear
komedyen - comedian - 
at - horse - no hint
değişim - change - no hint
şans - chance - no hint
bu ne tür bir yemek - what kind of dish is this - no hint
ihtiyac - need - et needs help because something is about to hit him, you quickly tell him he needs to dodge it "et ya..odge"
nokta - point - no hint
çelik - steel - no hint
işletmek - operate - no hint
kitap - book - no hint
ölçmek - measure - no hint
manüel - manual  automatic - 
milimetre - millimetre  millimeter - 
uygun - proper - no hint
hadi yirmi dakika içinde gidelim - lets leave in minutes - no hint
öğrenmek - learn - no hint
materyal - material materials - 
olay - event - no hint
vurmak - hit - no hint
ev - house - no hint
akış - flow - no hint
tuzlu - salty - in you twos, you love salt(tuz) + -lu(adjective ending)
üniforma - uniform - 
doğrudan - direct - no hint
öğretmek - teach - no hint
tepe - hill - no hint
aksiyon - action - 
sıcak - warm - no hint
insanlar - people - no hint
basit - simple - no hint
harika görünüyor - it looks great - no hint
kardeş - sister - no hint
harika - awesome - no hint
orta - middle - no hint
güçlü - strong - a really strong guy wearing gucci and louis vuitton. if gucci and louis vuitton combined, they would be the strongest fashion company in the world!
söylemek - to say - you say you like soylent
hareket - act - no hint
vadi - valley - no hint
alan - area - no hint
krem - cream for the skin colour - 
karakter - character - 
kostüm - costume - 
korumak - protect - no hint
disk - disk - 
hariç - except - no hint
yardım - help - no hint
bira - beer - the same word with an a on the end
ölçek - scale - no hint
yönetici - manager - someone says they are the manager, and someone else says "you not tj"
şimdi gidiyorum - i am leaving now - no hint
nazik - gentle - no hint
okumak - read - no hint
devlet - state - no hint
yöntem - method - no hint
vazo - vase - 
organizasyon - organization - 
kazanmak - to win - your cousin wins because she is on the top of the mountain
bariyer - barrier - 
mutfak - kitchen - a mute person can fuck in the kitchen and noone will hear
selfie - selfie - 
taş - stone - no hint
yol - road - no hint
ilginç - interesting - it would be very interesting if it turned out the grinch was ill, ilginç
hareket - move - no hint
politika - policy politics - 
ansiklopedi - encyclopaedia - 
bundan - from this - daniel boon got his power from this, being up at dawn
mutlu - happy - no hint
kardeş - brother - no hint
termometre - thermometer - 
meyve - fruit - maybe fruit is not so good for you
bütün - whole - no hint
son - last - no hint
uzay - space - no hint
lider - leader - 
öğle - its noon - no hint
fotokopi çekmek - to photocopy - 
ahşap - wood - no hint
acaba - wonder - no hint
yani - mean - no hint
hiç - ever - no hint
arazi - land - no hint
yedi - seven - no hint
kurşun kalem - pencil - an apple core has shown you a pencil, so you call them
susamış - thirsty - sammy sosa misses the ball because he is so thirsty
yüzey - surface - no hint
gökyüzü - sky - no hint
avro - euro - 
baskı - print - no hint
almak - to take - you take all the stuff
saat kaç - what time is it - no hint
yaklaşık iki hafta - about two weeks - no hint
beni affet lütfen - please forgive me - no hint
stres - stress feelings of worry or anxiety - 
hala - still - no hint
akademik - academic - 
ekşi - sour - "ek!" she says, "this is so sour!"
yalan - lie - no hint
dikkatli - careful - you have to be careful when you point your dick at lee
karbon - carbon - 
bir battaniye alabilir miyim - can i have a blanket - no hint
uçmak - fly - no hint
ne kötü bir hava - what bad weather - you have a nice day if the weather is good. literally, what bad a weather
spesifik - specific - 
üç ile beş iş günü arasında sürer - it takes three to five business days - no hint
demokrasi - democracy - 
atlama - jump - no hint
içinde - in - no hint
kötü - bad - no hint
sonrası - post - no hint
el - hand - no hint
kafe - café - 
alan - field - no hint
fotoğraf - photograph - 
düşman - enemy - no hint
şehir - city - no hint
var - have - no hint
poz - pose - no hint
dakika - minute - the kicker is that there is only a minute left
harika - great - it's great when you find gold so you say "harika" (yurika!)
yarın güneşli olacak - tomorrow will be sunny - no hint
görüş - sight - no hint
taksi - taxi - pretty much the same
teori - theory - 
tipi - type - no hint
gelmek - to come - you come gel
kamp - camp - no hint
koleksiyon - collection set  group - 
jenerasyon - generation - 
nereye gitmek istersin - where do you want to go - no hint
golf - golf - 
besleme - supply - no hint
saat - hour - you sat for an hour
strateji - strategy - 
kol - arm - it is cool to have tattoos on your arm
takvim - calendar - your futuristic calendar is just talking to a virtual machine
apartman - apartment block - 
empati - empathy - 
destek - support - no hint
mesaj almak - to get a message - 
içki - drink - no hint
sokak - street - no hint
negatif - negative - 
demokratik - democratic - 
izle - watch - no hint
ondalık - decimal - no hint
favori - favourite - 
ünlü - vowel - no hint
kahverengi - brown - no hint
ile - with - no hint
bunun için - for this - literally, this for
merkezi - center - no hint
masaj - massage - 
enstrüman - instrument of music - 
gün - day - no hint
geç - late - "getchur stuff, we're late"
motor - motor - 
senin - your - no hint
ee yeni birşey var mı - so what is new - no hint
elektrik - electricity - electricity is electric
organik - organic - 
beklettiğim için özür dilerim - sorry to keep you waiting - no hint
geometrik - geometric - 
psikolog - psychologist - 
momentum - momentum - 
pilot - pilot - 
hesap - check - no hint
akıllı - intelligent - a killer must be very intelligent
görünmek - seem - no hint
soru - question - no hint
olmak - to be - to be is to be old
hayal - imagine - no hint
parlak - bright - no hint
ağaç - tree - no hint
kampüs - campus - 
taze - fresh - no hint
garaj - garage carport - 
sıcacık - warm - similar to hot(sıcak), but with an extra 'ca' in the middle
şiir - poem - no hint
sahip olmak - to have - you see a heap of stuff and you want to have it
yetişkin - adult - when you are an adult, ya tish(tish) your kin
komik - funny - the comic is funny
ticaret - trade - no hint
yat - yacht - 
almak - receive - no hint
yarın güneşli ve yağışlı olacak - tomorrow will be sunny with showers - no hint
fonksiyon - function - 
yüzde yüz eminim - i am certain - no hint
levha - sheet - no hint
görünür - appear - no hint
paragraf - paragraph - no hint
opera - opera - 
sponsor - sponsor - 
hazır - ready - no hint
soğuk - cold - no hint
mıknatıs - magnet - no hint
şampiyon - champion - 
tank - tank - 
