misspell - . m. i. s. s. p. e. l. l. - write the letters of incorrectly
dissatisfy - d. i. s. s. a. t. i. s. f. y. - fail to please or meet expectations
dispensable - d. i. s. p. e. n. s. a. b. l. e. - capable of being eliminated or done without
questionnaire - q. u. e. s. t. i. o. n. n. a. i. r. e. - a form with a set of queries to gain statistical information
neutron - n. e. u. t. r. o. n. - a subatomic particle with zero charge
possessive - p. o. s. s. e. s. s. i. vee. e. - serving to express or indicate the act of having
weird - w. e. i. r. d. - fate personified; any one of the three weird sisters
fluorescent - f. l. u. o. r. e. s. c. e. n. t. - emitting light during exposure to external radiant energy
believable - b. e. l. i. e. vee. a. b. l. e. - capable of being accepted as true
harass - h. a. r. a. s. s. - annoy continually or chronically
idiosyncrasy - i. d. i. o. s. y. n. c. r. a. s. y. - a behavioral attribute peculiar to an individual
panicky - p. a. n. i. c. k. y. - thrown into a state of intense fear or desperation
realistically - r. e. a. l. i. s. t. i. c. a. l. l. y. - in a realistic manner
secede - s. e. c. e. d. e. - withdraw from an organization or polity
quandary - q. u. a. n. d. a. r. y. - state of uncertainty in a choice between unfavorable options
exaggerate - e. x. a. g. g. e. r. a. t. e. - enlarge beyond bounds or the truth
fascinate - f. a. s. c. i. n. a. t. e. - attract; cause to be enamored
mosquito - m. o. s. q. u. i. t. o. - two-winged insect that sucks the blood of humans and animals
hesitancy - h. e. s. i. t. a. n. c. y. - a feeling of diffidence and indecision about doing something
roommate - r. o. o. m. m. a. t. e. - an associate who shares a room with you
guerrilla - g. u. e. r. r. i. l. l. a. - a member of an irregular army that fights a stronger force
manageable - m. a. n. a. g. e. a. b. l. e. - capable of being controlled
rhythmical - r. h. y. t. h. m. i. c. a. l. - recurring with measured regularity
fallacious - f. a. l. l. a. c. i. o. u. s. - containing or based on incorrect reasoning
fulfill - f. u. l. f. i. l. l. - meet a want or need
pronunciation - p. r. o. n. u. n. c. i. a. t. i. o. n. - the manner in which someone utters a word
ideally - i. d. e. a. l. l. y. - in an ideal manner
aggravate - a. g. g. r. a. vee. a. t. e. - make worse
sacrilegious - s. a. c. r. i. l. e. g. i. o. u. s. - grossly irreverent toward what is considered holy
intercede - i. n. t. e. r. c. e. d. e. - act between parties with a view to reconciling differences
supersede - s. u. p. e. r. s. e. d. e. - take the place or move into the position of
quiz - q. u. i. z. - an examination consisting of a few short questions
stubbornness - s. t. u. b. b. o. r. n. n. e. s. s. - resolute adherence to your own ideas or desires
soliloquy - s. o. l. i. l. o. q. u. y. - speech you make to yourself
allege - a. l. l. e. g. e. - report or maintain
acclaim - a. c. c. l. a. i. m. - enthusiastic approval
equip - e. q. u. i. p. - provide with, usually for a specific purpose
heinous - h. e. i. n. o. u. s. - extremely wicked or deeply criminal
refrigerator - r. e. f. r. i. g. e. r. a. t. o. r. - white goods in which food can be stored at low temperatures
liaison - l. i. a. i. s. o. n. - a means of communication between groups
lenient - l. e. n. i. e. n. t. - inclined to be permissive or indulgent
quarantine - q. u. a. r. a. n. t. i. n. e. - isolation to prevent the spread of infectious disease
omit - o. m. i. t. - leave undone or leave out
counselor - c. o. u. n. s. e. l. o. r. - someone who gives advice about problems
scary - s. c. a. r. y. - provoking fear or terror
recede - r. e. c. e. d. e. - pull back or move away or backward
permissible - p. e. r. m. i. s. s. i. b. l. e. - acceptable, especially as according to rule
embarrass - e. m. b. a. r. r. a. s. s. - cause to feel self-conscious
hypocrisy - h. y. p. o. c. r. i. s. y. - pretending to have qualities or beliefs that you do not have
souvenir - s. o. u. vee. e. n. i. r. - something of sentimental value
simile - s. i. m. i. l. e. - a figure of speech expressing a resemblance between things
exuberance - e. x. u. b. e. r. a. n. c. e. - joyful enthusiasm
symmetrical - s. y. m. m. e. t. r. i. c. a. l. - exhibiting equivalence or correspondence among constituents
skiing - s. k. i. i. n. g. - a sport in which participants must travel on skis
millionaire - m. i. l. l. i. o. n. a. i. r. e. - a person whose material wealth is valued at more than a million dollars
maneuver - m. a. n. e. u. vee. e. r. - a military training exercise
hero - h. e. r. o. - (greek mythology) priestess of aphrodite who killed herself when her lover leander drowned while trying to swim the hellespont to see her
criticize - c. r. i. t. i. c. i. z. e. - point out real or perceived flaws
reminiscence - r. e. m. i. n. i. s. c. e. n. c. e. - a mental impression retained and recalled from the past
portray - p. o. r. t. r. a. y. - represent abstractly, for example in a painting
synonymous - s. y. n. o. n. y. m. o. u. s. - meaning the same or nearly the same
fallacy - f. a. l. l. a. c. y. - a misconception resulting from incorrect reasoning
curriculum - c. u. r. r. i. c. u. l. u. m. - an integrated course of academic studies
accumulate - a. c. c. u. m. u. l. a. t. e. - get or gather together
sophomore - s. o. p. h. o. m. o. r. e. - a second-year undergraduate
feasible - f. e. a. s. i. b. l. e. - capable of being done with means at hand
overrun - o. vee. e. r. r. u. n. - seize the position of and defeat
rhythm - r. h. y. t. h. m. - an interval during which a recurring sequence occurs
fundamentally - f. u. n. d. a. m. e. n. t. a. l. l. y. - in essence; at bottom or by one's (or its) very nature
millennium - m. i. l. l. e. n. n. i. u. m. - a span of 1000 years
disappoint - d. i. s. a. p. p. o. i. n. t. - fail to meet the hopes or expectations of
humorous - h. u. m. o. r. o. u. s. - characterized by the power to evoke laughter
courteous - c. o. u. r. t. e. o. u. s. - characterized by politeness and gracious good manners
financially - f. i. n. a. n. c. i. a. l. l. y. - from a financial point of view
receipt - r. e. c. e. i. p. t. - the act of receiving
hindrance - h. i. n. d. r. a. n. c. e. - any obstruction that impedes or is burdensome
hypocrite - h. y. p. o. c. r. i. t. e. - a person who professes beliefs that he or she does not hold
fictitious - f. i. c. t. i. t. i. o. u. s. - formed or conceived by the imagination
implement - i. m. p. l. e. m. e. n. t. - a piece of equipment or a tool used for a specific purpose
irrelevant - i. r. r. e. l. e. vee. a. n. t. - having no bearing on or connection with the subject at issue
rheumatism - r. h. e. u. m. a. t. i. s. m. - any painful disorder of the joints or muscles
reservoir - r. e. s. e. r. vee. o. i. r. - lake used to store water for community use
persistence - p. e. r. s. i. s. t. e. n. c. e. - continuing or repeating behavior
village - vee. i. l. l. a. g. e. - a mainly residential district of manhattan
schedule - s. c. h. e. d. u. l. e. - a list of times at which things are planned to occur
guarantee - g. u. a. r. a. n. t. e. e. - an unconditional commitment that something will happen
exhaust - e. x. h. a. u. s. t. - wear out completely
achievement - a. c. h. i. e. vee. e. m. e. n. t. - the action of accomplishing something
peaceable - p. e. a. c. e. a. b. l. e. - inclined or disposed to peace
vigilant - vee. i. g. i. l. a. n. t. - carefully observant or attentive
independence - i. n. d. e. p. e. n. d. e. n. c. e. - a city in western missouri
maintenance - m. a. i. n. t. e. n. a. n. c. e. - activity involved in keeping something in good working order
forfeit - f. o. r. f. e. i. t. - lose the right to or lose by some error, offense, or crime
deceive - d. e. c. e. i. vee. e. - cause someone to believe an untruth
vacuum - vee. a. c. u. u. m. - an empty area or space
drunkenness - d. r. u. n. k. e. n. n. e. s. s. - a temporary state resulting from excessive consumption of alcohol
apologize - a. p. o. l. o. g. i. z. e. - acknowledge faults or shortcomings or failing
likelihood - l. i. k. e. l. i. h. o. o. d. - the probability of a specified outcome
omission - o. m. i. s. s. i. o. n. - leaving out or passing over something
