no te preocupes - do not worry - no hint
hola - hello - no hint
reunirse - get together - no hint
a la ciudad - to the city - no hint
incluso - even - no hint
rápidamente - quickly - no hint
correr - run - no hint
instrumento - instrument - no hint
fuego - fire - no hint
en llamas - on fire - no hint
en casa - at home - no hint
estaba en mi bolso - it was in my bag - no hint
universal - universal - no hint
extranjero - foreign - no hint
huéspedes - guests - no hint
se requiere - is required - no hint
a quien le importa - who cares - no hint
a quien te importa - who cares - no hint
en ese caso - then - no hint
qué haces en tu tiempo libre - what do you do in your free time - no hint
esto es realmente útil - this is really useful - no hint
tiempo libre - free time - no hint
últimamente - lately - no hint
alrededor de las doce - around twelve - no hint
juntos - together - no hint
sueles dormir hasta tarde - you usually sleep late - no hint
es por eso - that39s why - no hint
lado europeo - european side - no hint
lado de anatolia - anatolian side - no hint
buena suerte para ti - good luck for you - no hint
es eso incorrecto - is that wrong - no hint
es esto correcto - is this correct - no hint
qué quieres decir - what do you mean - no hint
otro - other - no hint
buena suerte - good luck - no hint
doydun mu - doydun mu - no hint
por mi bien - for my sake - no hint
para qué - for what - no hint
tengo prisa - i39m in a hurry - no hint
eso espero - i hope so - no hint
calma - calm down - no hint
por cierto - by the way - no hint
cuantas veces - how often - no hint
estas durmiendo - are you sleeping - no hint
pero normalmente solo trabajo en turco - but normally i only work in turkish - no hint
que tipo de deportes haces - what kind of sports do you do - no hint
cómo te fué en el trabajo - how was work - no hint
eres muy solidario - you are very supportive - no hint
tengo suerte de ser tu amigo - i am lucky to be your friend - no hint
estaba muy adentro - i was deep inside - no hint
son tus películas divertidas favoritas - are your favorite funny movies - no hint
espero que hayas tenido un buen día - i hope you had a nice day - no hint
creo que es asi - think it is so - no hint
que debemos estudiar - what do we have to study - no hint
me harás una pregunta - will you ask me a question - no hint
no lamentablemente no entendí todo - no unfortunately i did not understand everything - no hint
creo que lo tengo - i think i got it - no hint
deberías decir eso - you should say that - no hint
tus palabras son muy notables - your words are very remarkable - no hint
estoy despierto - i39m awake - no hint
mi corazón se derritió - my heart melted - no hint
como estuvo tu caminar - how was your walk - no hint
y tú - and you - no hint
buena salud - good health - no hint
sin travesuras - no mischief - no hint
bien estoy haciendo esto - fine i39m doing this - no hint
seguimos intentando lo que sea - we keep trying whatever - no hint
no hemos hecho mucho hoy - we haven39t done much today - no hint
pero anoche me desperté como a la una tarde - but last night i woke up about one afternoon - no hint
qué hiciste hoy excepto el examen - what did you do today except the exam - no hint
espero que entiendas - i hope you understand - no hint
gracias por ayudarme - thanks for helping - no hint
creo que voy a jugar al tenis - i think i39m going to play tennis - no hint
creo que jugaré al tenis con mis hermanos - i think i will play tennis with my brothers - no hint
voy a programar - i39m going to program - no hint
haré un programa - i will make a program - no hint
esto o aquello cual es correcto - this or that which is correct - no hint
esta frase es nueva para mi - this phrase is new to me - no hint
me alegro de que puedas entenderme - i39m glad that you can understand me - no hint
si lo digo en serio - yes i say it seriously - no hint
pensé que había dicho lo siento - i thought i said sorry - no hint
tekirova es una ciudad pequeña - tekirova is a small town - no hint
me gusta asar verduras - i like to roast vegetables - no hint
tienes un talento increible - you have an incredible talent - no hint
me estás tomando el pelo - are you kidding me - no hint
hay mucha diferencia de edad entre mis hermanos - there is a lot of age difference between my brothers - no hint
dije tu nombre correctamente - i said your name correctly - no hint
tengo treinta y cuatro años - i39m thirty four years old - no hint
cuántos años tienes - how old are you - no hint
qué haces para divertirte - what do you do for fun - no hint
hiciste algo interesante hoy - did you do something interesting today - no hint
saludos - regards - no hint
tuviste un buen día - you had a good day - no hint
que estas haciendo - what are you doing - no hint
si yo tambien tuve un buen dia - yes i also had a good day - no hint
qué hiciste hoy - what did you do today - no hint
se siente como un buen dia - it feels like a good day - no hint
espero que estés bien - i hope you39re well - no hint
y espero que estés bien - and i hope you are well - no hint
espero que tengas un buen día - i hope you have a good day - no hint
todavía temprano aquí - still early here - no hint
no hice mucho - i didn39t do much - no hint
limpié la cocina - clean the kitchen - no hint
acabo de despertarme - i just woke up - no hint
acabo de hacer café - i just made coffee - no hint
dormí hasta tarde hoy - i slept late today - no hint
cabalgué bien - i rode well - no hint
no dormí mucho anteayer - i didn39t sleep much the day before yesterday - no hint
dormí bien - i slept well - no hint
mi día ha estado bien hasta ahora pero aún es temprano - my day has been good so far but it39s still early - no hint
como estuvo tu dia hiciste algo divertido - how was your day did you do something fun - no hint
no vi gambito de reinas - i did not see a queen39s gambit - no hint
seguramente mira el gambito de las reinas - surely look at the gambit of the queens - no hint
esto es un conjunto - this is a set - no hint
acabo de ver el primer episodio - i just saw the first episode - no hint
pero estoy emocionado de ver el próximo - but i39m excited to see the next one - no hint
te gustó la mayoría de mis publicaciones de instagram - you liked most of my instagram posts - no hint
ese festival se ve tan genial - that festival looks so cool - no hint
al mismo tiempo que el festival de malabares - at the same time as the juggling festival - no hint
he visto un últimamente y pensé que también era bueno para mí - i39ve seen one lately and i thought it was good for me too - no hint
tiene hermanos - do you have brothers - no hint
eres el mayor - you are the oldest - no hint
yo soy el segundo hijo - i am the second child - no hint
estás casado - are you married - no hint
qué edad tiene tu hija - how old is your daughter - no hint
tan dulce es una gran edad - so sweet it39s a great age - no hint
tengo una sobrina de tres años - i have a three year old niece - no hint
no tengo ninguna responsabilidad pero me divierto mucho - i have no responsibility but i have a lot of fun - no hint
no tengo mascota - i do not have pet - no hint
pero mi hermano tiene un gato - but my brother has a cat - no hint
fui a correr - i went for a run - no hint
compré café - i bought coffee - no hint
tuve una mañana productiva - i had a productive morning - no hint
si circo en ingles - yes circus in english - no hint
por qué quieres aprender turco - why do you want to learn turkish - no hint
tú que me enseñaste inglés y yo te hice turco - you who taught me english and i made you turkish - no hint
gracias por felicitar a mi turco - thank you for congratulating my turk - no hint
estoy muy impresionado por tu ingles - i am very impressed by your english - no hint
algún día espero hablar tan bien como tú - someday i hope to speak as well as you - no hint
uso mucho la traducción ahora - i use translation a lot now - no hint
escribir turco - write turkish - no hint
necesito más práctica oral - i need more oral practice - no hint
es mi pronunciación correcta - is my pronunciation correct - no hint
suficiente todo esta mal - enough everything is wrong - no hint
más natural - more natural - no hint
cuál es la diferencia entre esto y aquello - what is the difference between this and that - no hint
puedes usar esto en una oración - you can use this in a sentence - no hint
buen lenguaje - good language - no hint
como aprendiste ruso - how did you learn russian - no hint
cuánto tiempo llevas usando helllo tallkk - how long have you been using helllo tallkk - no hint
escribí pronombres en papel - i wrote pronouns on paper - no hint
a veces parece imposible - sometimes it seems impossible - no hint
tengo que hacer una frase solo - i have to do a sentence alone - no hint
uso muchas traducciones - i use a lot of translations - no hint
tienes un acento muy bonito - you have a very nice accent - no hint
gracias por el consejo - thanks for the advice - no hint
necesito ayuda con turco - i need help with turkish - no hint
me entiendes - do you understand me - no hint
estoy tratando de leer es dificil - i am trying to read it is difficult - no hint
estoy muy contento de que te guste mi habla turca me da motivación - i am very happy that you like my turkish speaking it gives me motivation - no hint
entiendes lo que digo - understand what i say - no hint
dónde vives en turquía - where do you live in turkey - no hint
vives en algún lugar del pavo - you live somewhere in turkey - no hint
de qué ciudad eres - what city are you from - no hint
soy turco de azerbaiyán - i am turk from azerbaijan - no hint
naciste ahí - you we're born there - no hint
cuando saliste - when did you leave - no hint
amo tu acento - i love your accent - no hint
está nevando mucho aquí ahora mismo - it39s snowing a lot here right now - no hint
alguna vez nieva donde estás - does it ever snow where are you - no hint
es muy inusual nevar aquí - it is very unusual to snow here - no hint
fui allí hace unos cuatro años - i went there about four years ago - no hint
no nunca lo hice - no i never did - no hint
visitaste allí - you visited there - no hint
has estado en el extranjero - have you been abroad - no hint
no nunca fui - no i never went - no hint
te mostraré los alrededores - i will show you around - no hint
no lamentablemente no pude irme - no unfortunately i couldn39t leave - no hint
no tengo dinero porque - i don39t have money because - no hint
tuve tres meses del año pasado en turquía - i had three months last year in turkey - no hint
tu trabajo te permite viajar mucho - your job allows you to travel a lot - no hint
fuiste a algunos lugares agradables - you went to some nice places - no hint
dónde te gustaría visitar en estados unidos - where would you like to visit in the united states - no hint
quiero venir este verano - i want to come this summer - no hint
depende de la pandemia - depends on the pandemic - no hint
toda mi vida esta viajando - all my life is traveling - no hint
pero viajo mucho - but i travel a lot - no hint
me quedé cerca de kadıköy - i stayed close to kadıköy - no hint
has estado alguna vez en el extranjero - have you ever been abroad - no hint
pero quizás más común en turquía - but maybe more common in turkey - no hint
mis amigos tienen un centro de circo en estambul - my friends have a circus center in istanbul - no hint
allí dan lecciones de circo - there they give circus lessons - no hint
eres estudiante - you are a student - no hint
qué estás leyendo - what are you reading - no hint
estoy estudiando quimica - i am studying chemistry - no hint
descubrió cómo aprobó su examen - found out how you passed your exam - no hint
tuviste una escuela hoy - you had a school today - no hint
cuantos años mas tienes - how old are you - no hint
cuantos años llevas estudiando en la universidad - how many years have you been studying at the university - no hint
cómo le fue en su examen - how did your exam go - no hint
espero que halla ido bien - i hope it went well - no hint
es esta una reunión escolar - is this a school meeting - no hint
será agradable cuando puedas volver a un salón de clases real - it will be nice when you can go back to a real classroom - no hint
cuantos años tienen los estudiantes - how old are the students - no hint
qué estás enseñando - what are you teaching - no hint
cuanto tiempo has enseñado - how long have you taught - no hint
yo era profesor - i was a teacher - no hint
cuantos estudiantes tenias - how many students did you have - no hint
haz tu trabajo - do your work - no hint
soy un malabarista - i am a juggler - no hint
soy un artista de circo - i am a circus artist - no hint
pero tuve mucho trabajo - but i had a lot of work - no hint
que vas a hacer cuando termine la universidad de verano - what are you going to do when i finish summer university - no hint
si este es un trabajo muy divertido que haces - if this is a very fun job that you do - no hint
arquitectura de interiores - interior architecture - no hint
a qué te dedicas - what do you do - no hint
cuánto tiempo has querido ser actor - how long have you wanted to be an actor - no hint
es genial que conozcas muy bien la ciencia - it39s great that you know science very well - no hint
creo que tu actuacion es buena - i think your acting is good - no hint
chica grosera supongo que su nombre es temporada - rude girl i guess her name is season - no hint
quiero que seamos amigos - i want us to be friends - no hint
eres gracioso me haces reir - you are funny you make me laugh - no hint
oh mi eres tan gracioso - oh my you are so funny - no hint
me encantaría jugar contigo también - i would love to play with you too - no hint
eres tan elegante - you are so elegant - no hint
te agradezco que digas eso - i appreciate you saying that - no hint
gracias eres dulce - thanks you39re sweet - no hint
muchas gracias eres tan amable - thank you very much you are so kind - no hint
pero se convirtió en un presidente muy extraño - but he became a very strange president - no hint
voy a correr - i39m going to run - no hint
duerme bien contigo - sleep well with you - no hint
tengo que ir - i have to go - no hint
fue muy agradable hablar contigo - it was very nice talking to you - no hint
disfruta el resto de la noche - enjoy the rest of the night - no hint
y espero hablar contigo pronto - and i hope to talk to you soon - no hint
espero que podamos hablar de nuevo pronto - hope we can talk again soon - no hint
definitivamente estás durmiendo ahora mismo - you are definitely sleeping right now - no hint
tuve un sueño - i had a dream - no hint
sueñas a menudo - you dream often - no hint
espero que tengas aventuras en tus sueños ahora mismo - i hope you have adventures in your dreams right now - no hint
si solo - yes alone - no hint
la gente ya aprende algo nuevo todos los días - people already learn something new every day - no hint
tengo una pregunta - i have a question - no hint
el me ama bien - he loves me well - no hint
no duermas demasiado tarde - don39t sleep too late - no hint
no importa ahora lo sé - it doesn39t matter now i know - no hint
el día acaba de comenzar - the day has just begun - no hint
se siente duro - feels hard - no hint
nombre en la parte superior - name at the top - no hint
me gustan ambos - i like both of them - no hint
antier - the day before yesterday - no hint
todo aqui es perfecto - everything here is perfect - no hint
te encontré en instagram - i found you on instagram - no hint
qué quieres decir - what do you mean - no hint
y puedo ayudarte - and i can help you - no hint
pero no tomará mucho tiempo - but it won39t take long - no hint
nunca he visto esto - i have never seen this - no hint
no hay nada de que disculparse - there is nothing to apologize for - no hint
las preguntas difíciles son buenas preguntas - hard questions are good questions - no hint
si eso sería muy bueno - yes that would be very good - no hint
el primero es el mejor - the first is the best - no hint
entonces tal vez sea bueno - then maybe it39s good - no hint
pero creo que lo es - but i think it is - no hint
todavía me queda una hora y media para esperar - i still have an hour and a half to wait - no hint
estaba hablando solo - i was talking to myself - no hint
entonces qué estás haciendo en su lugar - so what are you doing instead - no hint
cuál es la diferencia entre esto y aquello - what is the difference between this and that - no hint
hablaré contigo - i39ll talk to you - no hint
hablaré con mis otros amigos - i will talk to my other friends - no hint
envié un mensaje - i sent a message - no hint
esta es una oración completa - this is a complete sentence - no hint
tomar foto - take photo - no hint
lo percibí personalmente - i perceived it personally - no hint
sentí ganas de escribir una canción - i felt like writing a song - no hint
es esta una expresión común - is this a common expression - no hint
me gusta programar - i like to program - no hint
lo tomé ayer por la mañana - i took it yesterday morning - no hint
me cuesta hablar en persona - i find it difficult to speak in person - no hint
antes de enviar - before sending - no hint
normalmente puedo traducir y practicar antes de publicar un mensaje - i can usually translate and practice before posting a message - no hint
tengo algunas palabras que puedo usar ahora - i have some words that i can use now - no hint
practiqué turco - i practiced turkish - no hint
solo practico turco ahora mismo - i only practice turkish right now - no hint
vamos a hacerlo - let39s do it - no hint
miremos aquí - let39s look here - no hint
qué estoy haciendo - what am i doing - no hint
pero esta mañana temprano - but this morning early - no hint
fui a dar un paseo - i went for a walk - no hint
yo hacía malabares - i juggled - no hint
limpié el auto - i cleaned the car - no hint
bebí un poco de agua - i drank some water - no hint
creo que eso es todo - i think that39s all - no hint
llevé a mi hermano a algún lugar ahora lo estoy esperando - i took my brother somewhere now i39m waiting for him - no hint
solo fui a correr - i just went for a run - no hint
hasta ahora - until now - no hint
así que conducir y correr es todo lo que he hecho hoy - so driving and running is all i39ve done today - no hint
saliste el dia de hoy - did you go out today - no hint
tal vez al mercado o al parque - maybe to the market or the park - no hint
salió bien tu lección - your lesson went well - no hint
ya tienes los resultados - you already have the results - no hint
mago - wizard - no hint
verdadero - true - no hint
a clase - to class - no hint
espalda - back - no hint
puedes volver a - you can go back to - no hint
reunión - meeting - no hint
recientemente - recently - no hint
es eso - is that - no hint
no durará - it will not last - no hint
pedir disculpas - apologize - no hint
preguntas - questions - no hint
pienso - i think - no hint
tocar - to touch - no hint
elegante - elegant - no hint
sería - would - no hint
escuela secundaria - high school - no hint
universidad - college - no hint
asi que - so - no hint
propio - own - no hint
en lugar de - instead of - no hint
diferencia - difference - no hint
qué - that - no hint
divertido - funny - no hint
ciencias - sciences - no hint
tu actuación - your performance - no hint
suponer - suppose - no hint
pensar - to think - no hint
pienso - i think - no hint
común - common - no hint
estoy estresado - i39m stressed - no hint
mensaje - message - no hint
expresión - expression - no hint
tam - tam - no hint
atraer - attract - no hint
personal - personal - no hint
dentro de mi - inside of me - no hint
canción - song - no hint
puedo usar - i can use - no hint
hagamos - let39s do - no hint
en las horas - in the hours - no hint
todo - all - no hint
para ahora - for now - no hint
ud - out - no hint
resultado - result - no hint
estar lleno - be full - no hint
veces - times - no hint
disponible - available - no hint
terminado - finished - no hint
apoyo - support for - no hint
atraer - attract - no hint
pensar - to think - no hint
deberías decir - you should say - no hint
consideración - consideration - no hint
despierto - awake - no hint
además - what39s more - no hint
oído - hearing - no hint
corazón - heart - no hint
gracias - thank you - no hint
favor - favor - no hint
favor - favor - no hint
salud - health - no hint
travesura - mischief - no hint
detener - stop - no hint
me gustó - i liked - no hint
lo siento - sorry - no hint
diferencia - difference - no hint
clínica - clinic - no hint
clásico - classic - no hint
esfuerzo - effort - no hint
información - information - no hint
islam - islam - no hint
cantina - cellar - no hint
canal - channel - no hint
comedia - comedy - no hint
crisis - crisis - no hint
extremo - extreme - no hint
ideología - ideology - no hint
ideológico - ideological - no hint
chaqueta - jacket - no hint
corán - koran - no hint
laboratorio - laboratory - no hint
recreación - recreation - no hint
líder - leader - no hint
melodía - melody - no hint
milímetro - millimeter - no hint
original - original - no hint
campaña - bell - no hint
cáncer - cancer - no hint
campeón - champion - no hint
personaje - character - no hint
koro - koro - no hint
kompleks - kompleks - no hint
composición - composition - no hint
control - control - no hint
crema - cream - no hint
crema - cream - no hint
tarjeta de crédito - credit card - no hint
dentro - inside - no hint
la licenciatura - degree - no hint
detective - detective - no hint
la economía - the economy - no hint
económico - economic - no hint
enérgico - energetic - no hint
exótico - exotic - no hint
adicional - additional - no hint
favorito - favorite - no hint
federal - federal - no hint
película - movie - no hint
final - final - no hint
gris - grey - no hint
garantizado - guaranteed - no hint
armonía - harmony - no hint
helicóptero - helicopter - no hint
hobby - hobby - no hint
industrial - industrial - no hint
inflación - inflation - no hint
irónico - ironic - no hint
jurado - jury - no hint
lamba - lamba - no hint
liberal - liberal - no hint
revista - magazine - no hint
gerente - manager - no hint
partido - match - no hint
dejar un mensaje - leave a message - no hint
menú - menu - no hint
metáfora - metaphor - no hint
metrópoli - metropolis - no hint
metros - meters - no hint
impulso - impulse - no hint
orgánico - organic - no hint
organizar - organize - no hint
organización - organization - no hint
aparcar el vehículo - park the vehicle - no hint
oxígeno - oxygen - no hint
paquete - package - no hint
él dijo - he said - no hint
botón - button - no hint
partido - match - no hint
carbohidrato - carbohydrate - no hint
carbón - coal - no hint
mapa - map - no hint
carrera - career - no hint
catalogo - catalog - no hint
católico - catholic - no hint
suave - gentle - no hint
chocolate - chocolate - no hint
cine - movies - no hint
civil - civil - no hint
café - coffee - no hint
colectivo - collective - no hint
colonia - suburb - no hint
cómico - funny - no hint
comunicación - communication - no hint
concentración - concentration - no hint
copiar - copy - no hint
corredor - runner - no hint
crédito - credit - no hint
criterio - criterion - no hint
cultural - cultural - no hint
detalle - detail - no hint
diplomático - diplomatic - no hint
diploma - diploma - no hint
directamente - directly - no hint
documento - document - no hint
enciclopedia - encyclopedia - no hint
garaje - garage - no hint
generacion - generation - no hint
es - is - no hint
garantía - warranty - no hint
hamburguesa - burger - no hint
honor - honor - no hint
hotel - hotel - no hint
ilegal - illegal - no hint
espejismo - mirage - no hint
índice - index - no hint
integración - integration - no hint
internacional - international - no hint
instituto - institute - no hint
ironía - irony - no hint
chorro - jet - no hint
liga - league - no hint
limonada - lemonade - no hint
límite - limit - no hint
listar - lists - no hint
vestíbulo - lobby - no hint
masajear - massage - no hint
local - local - no hint
medalla - medal - no hint
mensaje - message - no hint
millón - million - no hint
hacerse millonario - become a millionaire - no hint
millonario - millionaire - no hint
mental - mental - no hint
molécula - molecule - no hint
musulmán - muslim - no hint
objetivo - target - no hint
organo - organ - no hint
panel - panel - no hint
parque - park - no hint
pasta - pasta - no hint
multa - more - no hint
personal - personal - no hint
cable - cable - no hint
cacao - cocoa - no hint
cámara - camera - no hint
instalaciones - facilities - no hint
capacidad - capacity - no hint
capitán - captain - no hint
caravana - caravan - no hint
carnaval - carnival - no hint
categoría - category - no hint
camiseta de manga corta - tshirt - no hint
química - chemistry - no hint
cristiano - christian - no hint
cigarrillo - cigarette - no hint
club - club - no hint
kola - kola - no hint
cómico - funny - no hint
comité - committee - no hint
complicado - complicated - no hint
el concepto - the concept - no hint
prima - before - no hint
crítica - review - no hint
democracia - democracy - no hint
democrático - democratic - no hint
depresión - depression - no hint
diseño - design - no hint
diálogo - dialogue - no hint
digital - digital - no hint
desventaja - disadvantage - no hint
disciplina - discipline - no hint
drama - drama - no hint
doctor - doctor - no hint
empatía - empathy - no hint
energía - energy - no hint
equipo - team - no hint
experto - expert - no hint
federación - federation - no hint
finanzas - finance - no hint
financiero - financial - no hint
formato - format - no hint
foro - forum - no hint
ful - ful - no hint
función - function - no hint
galería - gallery - no hint
gas - gas - no hint
gendarme - policeman - no hint
caballero - gentleman - no hint
geometría - geometry - no hint
gol - goal - no hint
golf - golf - no hint
gramática - grammar - no hint
grupo - group - no hint
guitarra - guitar - no hint
gimnasia - gymnastics - no hint
habitat - habitat - no hint
dónde - where - no hint
hockey - hockey - no hint
hipótesis - hypothesis - no hint
ideal - ideal - no hint
ilusionista - illusionist - no hint
imagen - image - no hint
internet - internet - no hint
brocheta - pike - no hint
kilómetro - kilometer - no hint
limón - lemon - no hint
lira - lira - no hint
litro - liter - no hint
para enmascarar - to mask - no hint
máquina - machine - no hint
manual - manual - no hint
marcha - march - no hint
máscara - mask - no hint
material bélico - war material - no hint
matemáticas - math - no hint
podrá - may - no hint
mecanismo - mechanism - no hint
enviar mensaje - send message - no hint
transmitir un mensaje - convey a message - no hint
metáfora - metaphor - no hint
método - method - no hint
carro - car - no hint
música - song - no hint
musical - musical - no hint
con - with - no hint
negativo - negative - no hint
normal - normal - no hint
nota - note - no hint
número - number - no hint
oficina - office - no hint
juegos olímpicos - olympic games - no hint
ópera - opera - no hint
operación - operation - no hint
fotocopiar - photocopy - no hint
pánico - panic - no hint
pareja - partner - no hint
activar - activate - no hint
pimienta - pepper - no hint
rendimiento - performance - no hint
perspectiva - perspective - no hint
fobia - phobia - no hint
fonética - phonetics - no hint
bot - bot - no hint
badigard - badigard - no hint
bomba - bomb - no hint
kafe - kafe - no hint
centímetro - centimeter - no hint
colección - collection - no hint
concierto - concert - no hint
conferencia - conference - no hint
contrato - contract - no hint
disfraz - costume - no hint
cultura - culture - no hint
diplomático - diplomatic - no hint
disco - disk - no hint
dólar - dollar - no hint
editor - editor - no hint
electrónico - electronic - no hint
principio moral - moral principle - no hint
étnico - ethnic - no hint
euro - euro - no hint
ejercicio - exercise - no hint
factor - factor - no hint
terminar - end up - no hint
galaxia - galaxy - no hint
general - general - no hint
general - general - no hint
geografía - geography - no hint
geométrico - geometric - no hint
global - global - no hint
alo - alo - no hint
idealista - idealistic - no hint
endirekt - endirekt - no hint
infección - infection - no hint
instrumento - instrument - no hint
kilogramo - kilogram - no hint
legal - legal - no hint
licencia - license - no hint
cabildear - lobby - no hint
mercado - market - no hint
masaje - massage - no hint
máximo - maximum - no hint
mecánico - mechanical - no hint
mineral - mineral - no hint
mínimo - minimum - no hint
microbús - minibus - no hint
minifalda - mini skirt - no hint
minibar - minibar - no hint
modelo - model - no hint
moderno - modern - no hint
moral - moral - no hint
motor - motor - no hint
museo - museum - no hint
natural - natural - no hint
nota - note - no hint
juegos olímpicos - olympic games - no hint
entrar en pánico - panic - no hint
organizar - organize - no hint
período - time course - no hint
dirección - address - no hint
asistan - attend - no hint
rama - raman - no hint
ceremonia - ceremony - no hint
cristal - crystal - no hint
facultad - faculty - no hint
fútbol - soccer - no hint
forma - form - no hint
funcional - functional - no hint
gramo - gram - no hint
media - media - no hint
metalizado metalico - metallic metallic - no hint
motivación - motivation - no hint
nuclear - nuclear - no hint
operador - operator - no hint
rociar - spray - no hint
telescopio - telescope - no hint
terror - terror - no hint
terrorista - terrorist - no hint
automático - automatic - no hint
galleta - cracker - no hint
patata - potato - no hint
príncipe - the prince - no hint
promoción - promotion - no hint
proteína - protein - no hint
riesgo - risk - no hint
rutina - routine - no hint
ensalada - salad - no hint
sexo opuesto - opposite sex - no hint
simpático - kind - no hint
técnico - technical - no hint
tecnología - technology - no hint
telegrafiar - telegraph - no hint
terrorismo - terrorism - no hint
arena - arena - no hint
atleta - athlete - no hint
auto - auto - no hint
autobiografía - autobiography - no hint
versión - version - no hint
balcón - balcony - no hint
biología - biology - no hint
oficina - office - no hint
posición - position - no hint
perfil - profile - no hint
protesta - protest - no hint
radical - radical - no hint
racional - rational - no hint
emparedado - sandwich - no hint
deporte - sport - no hint
estadio - stadium - no hint
estándar - standard - no hint
quedar asombrado - be surprised - no hint
estratégico - strategic - no hint
supermercado - supermarket - no hint
simpatía - sympathy - no hint
táctica - tactic - no hint
taxi - taxi - no hint
telegrama - telegram - no hint
llamar por teléfono - call by telephone - no hint
televisión - tv - no hint
zona tropical - tropical zone - no hint
túnel - tunnel - no hint
atletismo - athletics - no hint
apartamento - apartment - no hint
agosto - august - no hint
universidad - college - no hint
video - video - no hint
carro - car - no hint
visión - vision - no hint
globo - globe - no hint
banco - bank - no hint
baloncesto - basketball - no hint
blucin kot - blucin kot - no hint
bravo - bravo - no hint
fotocopia - photocopy - no hint
foto - photo - no hint
hacer un picnic - have a picnic - no hint
pizza - pizza - no hint
piano - plan - no hint
político - political - no hint
retrato - portrait - no hint
popular - popular - no hint
potencial - potential - no hint
paune - paune - no hint
profesor - teacher - no hint
procedimiento - process - no hint
protokol - protokol - no hint
psicología - psychology - no hint
arriesgado - risky - no hint
psicólogo - psychologist - no hint
realista - realistic - no hint
realidad - reality - no hint
dieta - diet - no hint
restaurante - restaurant - no hint
robot - robot - no hint
cohete - rocket - no hint
papel - paper - no hint
romántico - romantic - no hint
guión - screenplay - no hint
selfie - selfie - no hint
seminario - seminar - no hint
champú - shampoo - no hint
social - social - no hint
estación - station - no hint
sorpresa - surprise - no hint
estado - condition - no hint
estrategia - strategy - no hint
estrés - stress - no hint
subjetivo - subjective - no hint
sorpresa - surprise - no hint
símbolo - symbol - no hint
simbólico - symbolic - no hint
sistema - system - no hint
tableta - tablet - no hint
tanque - tank - no hint
tecnológico - technological - no hint
teléfono - telephone - no hint
tenis - tennis - no hint
prueba - proof - no hint
activo - active - no hint
anti - anti - no hint
tropical - tropical - no hint
uniforme - uniform - no hint
unidad - unit - no hint
jarrón - vase - no hint
virus - virus - no hint
bacterias - bacteria - no hint
visionario - visionary - no hint
vitamina - vitamin - no hint
bar - bar - no hint
barrera - barrier - no hint
biológico - biological - no hint
fotografiar - to photograph - no hint
física - physics - no hint
piano - plan - no hint
oficial de policía - police officer - no hint
piloto - pilot - no hint
policía - policeman - no hint
política - politics - no hint
política - politics - no hint
positivo - positive - no hint
práctico - practical - no hint
pratik n - pratik n - no hint
presentación - presentation - no hint
profesional - professional - no hint
programa - program - no hint
proyecto - draft - no hint
reforma - reform - no hint
informe - report - no hint
romance - romance - no hint
sos - you are - no hint
escándalo - scandal - no hint
sector - sector - no hint
secular - secular - no hint
servicio - service - no hint
show - show - no hint
especulación - speculation - no hint
estrella - star - no hint
estudio - study - no hint
caramelo - candy - no hint
súper - super - no hint
academia - academy - no hint
ácido - acid - no hint
actriz - actress - no hint
ventaja - advantage - no hint
tragedia - tragedy - no hint
antidemocrático - antidemocratic - no hint
aritmética - arithmetic - no hint
tubo - tube - no hint
alfabeto - alphabet - no hint
universal - universal - no hint
volumen - volume - no hint
yate - i already - no hint
bicicleta - bicycle - no hint
picnic - picnic - no hint
póster - poster - no hint
princesa - princess - no hint
principio - beginning - no hint
problema - issue - no hint
protestar - to protest - no hint
radio - radio - no hint
reacción - reaction - no hint
modelo a seguir - model to follow - no hint
zapatos - shoes - no hint
secretario - secretary - no hint
sexo - sex - no hint
sexy - sexy - no hint
específico - specific - no hint
tener sexo - have sex - no hint
teológico - theological - no hint
termometros - thermometers - no hint
baño - bath - no hint
alternativa - alternative - no hint
aficionado - amateur - no hint
tráfico - traffic - no hint
tren - train - no hint
antipatía - antipathy - no hint
antipatik - antipatik - no hint
astronauta - astronaut - no hint
vóleibol - volleyball - no hint
equipaje - baggage - no hint
grande - great - no hint
plástico - plastic - no hint
patrocinador - sponsor - no hint
aksan - aksan - no hint
acción - action - no hint
terapeuta - therapist - no hint
teoría - theory - no hint
alcohol - alcohol - no hint
alcohólico - alcoholic - no hint
tipo - kind - no hint
turismo - sightseeing - no hint
analiz - analiz - no hint
trágico - tragic - no hint
académico - academic - no hint
consejo - tip - no hint
teatro - theater - no hint
terapia - therapy - no hint
teología - theology - no hint
actor - actor - no hint
adaptación - adaptation - no hint
teórico - theoretical - no hint
alarma - alarm - no hint
álbum - album - no hint
tomate - tomatoes - no hint
tu - you - no hint
ambulancia - ambulance - no hint
camiseta de manga corta - tshirt - no hint
televisor - television - no hint
bien - well - no hint
texto - text - no hint
turista - tourist - no hint
torneo - tournament - no hint
transferir - transfer - no hint
tolerancia - tolerance - no hint
saber - to know - no hint
hipocresía - hypocrisy - no hint
tragar la pastilla - swallow the pill - no hint
salud a tus manos - health to your hands - no hint
te cuento mas tarde es una larga historia - i39ll tell you later it39s a long story - no hint
tienes un corazón muy limpio - you have a very clean heart - no hint
buenas noches dios te bendiga - good night god bless you - no hint
poner la mente - put the mind - no hint
buena suerte para usted - good luck to you - no hint
que lindo bebe no debe tocar el mal de ojo - what a cute baby should not touch the evil eye - no hint
escucha con todos los oídos - listen with all ears - no hint
no puedo caber dentro de mi - i can39t fit inside of me - no hint
llano - flat - no hint
no más - no more - no hint
revisión - revision - no hint
pesado - heavy - no hint
agrio - sour - no hint
tarde - late - no hint
por supuesto - of course - no hint
responsabilidad - responsibility - no hint
por favor siéntate - please sit down - no hint
está bien si no vienes - it39s ok if you don39t come - no hint
seguramente lo encontraré donde sea - i will surely find it wherever - no hint
personalmente - personally - no hint
regular - regular - no hint
hielo - ice - no hint
contra - against - no hint
central - central - no hint
pongo mi ropa en la lavadora - i put my clothes in the washing machine - no hint
perfecto - perfect - no hint
tarjeta de débito - debit - no hint
natural - natural - no hint
nacer - be born - no hint
cerdo - pig - no hint
diferente - different - no hint
deseo - desire - no hint
marido - husband - no hint
frase - phrase - no hint
broma - joke - no hint
inteligente - smart - no hint
vulgar - vulgar - no hint
cocina - kitchen - no hint
por ciento - percent - no hint
oficial de policía - police officer - no hint
serie - series - no hint
fuerte - strong - no hint
frio - cold - no hint
nervioso - nervous - no hint
especial - special - no hint
consejo - tip - no hint
mujer - woman - no hint
lugar - place - no hint
en el piso - on the floor - no hint
puedes bajar de peso si te importa - you can lose weight if you mind - no hint
casi crepúsculo - almost twilight - no hint
por mi mismo - myself - no hint
posible - possible - no hint
llorar - mourn - no hint
tocar - to touch - no hint
lápiz - pencil - no hint
es este un libro viejo - is this an old book - no hint
ver - watch - no hint
no es relevante - it is not relevant - no hint
ana - mother - no hint
ha aumentado - has increased - no hint
mismo - same - no hint
bari - bari - no hint
antibiótico - antibiotic - no hint
carne de vaca - beef - no hint
lamento haberte hecho esperar - i39m sorry i made you wait - no hint
joven - young man - no hint
nube - cloud - no hint
nieva - snows - no hint
kare - kare - no hint
teléfonos móviles - mobile phones - no hint
té - has - no hint
traductor - translator - no hint
muy - very - no hint
expulsar - expel - no hint
tan bueno como - as good as - no hint
de esto - from this - no hint
soleado - sunny - no hint
decir - tell - no hint
llamar - call - no hint
grave - grave - no hint
ayer - yesterday - no hint
interior - interior - no hint
pan - pan - no hint
vestido - dress - no hint
electricidad - electricity - no hint
divertirse - have fun - no hint
fundir - meetings - no hint
cónyuge - spouse - no hint
necesitar - need - no hint
episodio - episode - no hint
sabah - sabah - no hint
me gusta - i like - no hint
barato - cheap - no hint
el lo hizo - he did it - no hint
actuar - act - no hint
desconcertante - baffling - no hint
absolutamente - absolutely - no hint
ejercicio - exercise - no hint
cuando esté terminado - when finished - no hint
ganamos - we won - no hint
yo no salí - i did not go out - no hint
no pude salir - i could not get out - no hint
ancho - broad - no hint
descanso - break - no hint
demás - the rest - no hint
meter en - meters and - no hint
ser requerido - be required - no hint
muy - very - no hint
lástima - pity - no hint
desaparecido - missing - no hint
error - error - no hint
todavía - yet - no hint
pierna - leg - no hint
tomar medicina - take medicine - no hint
contacto - contact - no hint
sueños - dreams - no hint
carta - paper - no hint
ruidoso - loud - no hint
su comida está lista para comer - your food is ready to eat - no hint
hm donde sea que vayamos ahora - hm wherever we go now - no hint
estoy muy listo para viajar de nuevo - i am very ready to travel again - no hint
listo - ready - no hint
evolución humana - human evolution - no hint
nervioso - nervous - no hint
estoy agradecido - i39m thankful - no hint
dedo - finger - no hint
cobre - copper - no hint
a mí mismo - to myself - no hint
miré a los estantes - i looked at the shelves - no hint
máquina - machine - no hint
correo - mail - no hint
deje - leave - no hint
señal - sign - no hint
si no lo soy - if i39m not - no hint
deseo - desire - no hint
a ver - let39s see - no hint
oportunidad - chance - no hint
exacto - exactly - no hint
sobre - on - no hint
si hay - yes there are - no hint
si - and - no hint
mejor - better - no hint
ahora - now - no hint
soltero - single - no hint
deseo lo mejor - i wish you the best - no hint
bolso - bag - no hint
cálmate - take it easy - no hint
adán - adam - no hint
probablemente - probably - no hint
pronunciación - pronunciation - no hint
el bebe cae al suelo - the baby falls to the ground - no hint
extranjero - foreign - no hint
sobrino - nephew - no hint
cuerpo - body - no hint
hacer - do - no hint
pandemia - pandemic - no hint
cabeza - head - no hint
salado - salty - no hint
no encaja en - does not fit in - no hint
hacer - do - no hint
dormir - to sleep - no hint
depende - depends - no hint
albergue - hostel - no hint
calcetines - socks - no hint
yo espero - i expect - no hint
malo - little - no hint
malo - little - no hint
nublado - cloudy - no hint
frío - cold - no hint
columna - column - no hint
enojo de nuevo - anger again - no hint
bien - well - no hint
cerca - search for - no hint
todos lo aman - everyone loves it - no hint
excluyendo - excluding - no hint
novio - boyfriend - no hint
ambas cosas - both - no hint
esta es una mala noticia - this is bad news - no hint
el verano - summer - no hint
fuera de lo común - out of the ordinary - no hint
ser cruel - be cruel - no hint
ser requerido - be required - no hint
vulgar - vulgar - no hint
bicicleta - bicycle - no hint
tímido - shy - no hint
café - coffee - no hint
peculiar - peculiar - no hint
debajo de la cama - under the bed - no hint
largo - length - no hint
ser afectado - be affected - no hint
parecer - seem - no hint
aksan - aksan - no hint
terrible - terrible - no hint
interesante - interesting - no hint
costa - costa - no hint
donde esta el gran asiento - where is the big seat - no hint
estupendo - great - no hint
te escucho con todos los oídos - i hear you with all ears - no hint
ningún libro debe tirarse a la basura - no book should be thrown away - no hint
malabares - juggling - no hint
hokkabaz - hokkabaz - no hint
regular - regular - no hint
baño - bath - no hint
usted dijo - you said - no hint
verduras - vegetables - no hint
perder - to lose - no hint
desconcertante - baffling - no hint
identificación - id - no hint
tengo que instalar - i have to install - no hint
aprendiste - did you learn - no hint
autobús - bus - no hint
satisfecho - satisfied - no hint
listado - list - no hint
me encantaría - i would love to - no hint
mascota - mascot - no hint
novia - bride - no hint
sendero para caminar es genial - walking trail is great - no hint
un poco más tarde probablemente haga ejercicio jugando al tenis o trotando - a little later you will probably exercise playing tennis or jogging - no hint
en tus sueños - in your dreams - no hint
fue aclarado - was cleared - no hint
estás bien - you are well - no hint
girar a la derecha en la primera rotonda - turn right at the first roundabout - no hint
tu pez tiene nombre - your fish has a name - no hint
ayudar - to help - no hint
recordé otro drama que amaba - i remembered another drama that i loved - no hint
de inglés - of english - no hint
bien tu - well you - no hint
suena como - sounds like - no hint
el momento más vergonzoso es un secreto - the most embarrassing moment is a secret - no hint
mi turco no es tan bueno como parece - my turk is not as good as it seems - no hint
mi turco es mejor de lo que parece - my turkish is better than it looks - no hint
cual es la proxima parada - what is the next stop - no hint
lo que dije - what i said - no hint
estaré disponible para hacer una llamada pronto - i will be available to make a call soon - no hint
la tienda cierra después de las seis en punto - the store closes after six o39clock - no hint
para esto - for this - no hint
mentirle es lo peor - lying to him is the worst - no hint
hasta ahora todo bien - so far so good - no hint
eso suena mejor - that sounds better - no hint
desafortunadamente - unfortunately - no hint
de dónde eres - where are you from - no hint
algo terrible dijiste - something terrible did you say - no hint
delicioso - delicious - no hint
disculpa - excuses - no hint
famoso - famous - no hint
aventuras - adventures - no hint
hijo - son - no hint
en la mesa - in the table - no hint
fruta - fruit - no hint
mide - measure - no hint
posible ir - possible to go - no hint
arquitectura - architecture - no hint
casado - married - no hint
posible - possible - no hint
músico - musician - no hint
sin impureza - without impurity - no hint
cocina - kitchen - no hint
ingeniero - engineer - no hint
fácil - easy - no hint
déjame ver a mi amado más de cerca - let me see my beloved more closely - no hint
que has pasado - what have you been through - no hint
mi turco se ve mejor de lo que es - my turk looks better than it is - no hint
es difícil controlarte a ti mismo - it39s hard to control yourself - no hint
de todas formas - anyway - no hint
de todos modos déjame decir al menos - anyway let me say at least - no hint
para hacer - to make - no hint
ahi - over there - no hint
para mis hijos - for my children - no hint
dar dinero - give money - no hint
eso - that - no hint
nuevo - new - no hint
subiendo - going up - no hint
servido con crema de tarta de manzana - served with apple tart cream - no hint
el ascensor sube - the elevator goes up - no hint
decir - tell - no hint
ver - watch - no hint
salir de noche - nightlife - no hint
venir - come - no hint
comida - meal - no hint
van a esquiar todos los inviernos - they go skiing every winter - no hint
no hay mucho que hacer mañana - not much to do tomorrow - no hint
mucho - a lot - no hint
su - it's - no hint
no - no - no hint
humano - human - no hint
en - in - no hint
hasta - until - no hint
más - plus - no hint
su hija es tan linda - your daughter is so cute - no hint
el pan está en la mesa - the bread is on the table - no hint
mi casa esta cerca del rio - my house is near the river - no hint
tu eres el unico que lo entiende - you are the only one who understands it - no hint
antes del mediodia - before noon - no hint
cuando - when - no hint
de esa manera - that way - no hint
la caja de estos es roja - the box of these is red - no hint
esta muy oscura esta noche - it39s very dark tonight - no hint
podría ser cualquier chica - could be any girl - no hint
uno - one - no hint
por qué es este regalo mamá y papá - why is this gift mom and dad - no hint
en la casa - in the house - no hint
es un buen amigo - he is a good friend - no hint
por - by - no hint
usar - to use - no hint
se ve caliente - looks hot - no hint
déjame ver de cerca - let me take a closer look - no hint
el problema es no dar dinero - the problem is not giving money - no hint
salgan - come out - no hint
cenamos en la cocina - we had dinner in the kitchen - no hint
cada invierno - every winter - no hint
cuál es tu nombre - what39s your name - no hint
nuestras costumbres son extraordinarias - our customs are extraordinary - no hint
muy - very - no hint
este regalo - this gift - no hint
más hermosa - more beautiful - no hint
nosotros - we - no hint
este suéter es de tamaño pequeño - this sweater is small size - no hint
su hija - his daughter - no hint
autocontrol - selfcontrol - no hint
encima - above - no hint
un nuevo reloj - a new watch - no hint
dentro - inside - no hint
sólo yo - just me - no hint
jugando bien - playing well - no hint
posible - possible - no hint
volverse amigos - become friends - no hint
regresaré el próximo año - i will be back next year - no hint
entonces - then - no hint
beber café después de la cena - drink coffee after dinner - no hint
después de las seis - after six - no hint
más hermoso - more beautiful - no hint
nuestra casa está cerca del océano - our house is near the ocean - no hint
fue por ese camino - went that way - no hint
dentro de la casa - inside the house - no hint
iré allí ahora - i will go there now - no hint
no es bueno repetir todo lo que escuchas - it is not good to repeat everything you hear - no hint
repite todo lo que escuchas - repeat everything you hear - no hint
hace calor afuera hoy - it39s hot outside today - no hint
hacer - do - no hint
no uses esa computadora - don39t use that computer - no hint
estamos comiendo en la cocina - we are eating in the kitchen - no hint
a ella le encanta - she loves it - no hint
prueba cosas - try things - no hint
como - what - no hint
sólo quiero - i only want - no hint
bebida - drink - no hint
compré tres boletos - i bought three tickets - no hint
es este regalo mío - is this gift of mine - no hint
pequeño - little - no hint
esta casa es mas linda - this house is prettier - no hint
tu nombre - your name - no hint
ellos - they - no hint
ntro - our - no hint
yo solo - only me - no hint
su - it's - no hint
bailando conmigo - dancing with me - no hint
ben - ben - no hint
gato debajo de la cama - cat under the bed - no hint
con - with - no hint
cocinaré mañana - i will cook tomorrow - no hint
cae al piso - fall to the floor - no hint
posible - possible - no hint
seis - six - no hint
hora - hour - no hint
hacer - do - no hint
su - it's - no hint
si se han ido déjame ir también - if they are gone let me go too - no hint
si no vuelven - if they don39t come back - no hint
el mas vergonzoso - the most embarrassing - no hint
solo una noche - just one night - no hint
serias mas feliz si no lo fuera - you would be happier if it weren39t - no hint
mi primer dia - my first day - no hint
el perro corre dentro de la casa - the dog runs inside the house - no hint
estás - these - no hint
mi hogar - my home - no hint
antes de - before - no hint
mentirle - lie to him - no hint
ser - to be - no hint
hoy - today - no hint
estará soleado hoy - it will be sunny today - no hint
después de la cena - after dinner - no hint
el equipo esta jugando bien - the team is playing well - no hint
nos vamos ahora - we39re leaving now - no hint
nos vamos ahora - we39re leaving now - no hint
intra - get in - no hint
su - it's - no hint
hacer los deberes - do homework - no hint
hasta la mañana - until the morning - no hint
tengo tiempo hasta la mañana - i have time until the morning - no hint
no es mio - it is not mine - no hint
me gusta - i like - no hint
conseguir el libro - get the book - no hint
usando la computadora - using the computer - no hint
oír - hear - no hint
dar - but - no hint
como la seda - like silk - no hint
los fantasmas realmente existen - ghosts really exist - no hint
todo no se puede solo querer - everything cannot just be wanted - no hint
adquisitivo - purchasing - no hint
intentando ayer hoy se olvidan las cosas - trying yesterday today forget things - no hint
salir de noche no es bueno - going out at night is not good - no hint
ver - watch - no hint
solo soy un pobre - i39m just poor - no hint
su - it's - no hint
lunes - monday - no hint
ahora - now - no hint
te gustaría bailar conmigo - would you like to dance with me - no hint
pequeño - little - no hint
su cabello la hacía distinta - her hair made her different - no hint
propio - own - no hint
solo nos quedamos una noche - we only stayed one night - no hint
cerca - search for - no hint
ayer - yesterday - no hint
ayer por la mañana - yesterday morning - no hint
quiero un reloj nuevo - i want a new watch - no hint
su bolsa - your bag - no hint
asiento grande - big seat - no hint
caja de estos - box of these - no hint
su bolsa es pesada - her bag is heavy - no hint
un dia soleado - a sunny day - no hint
malas noticias - bad news - no hint
derribarle - knock him down - no hint
tal vez llueva - maybe it will rain - no hint
hasta - until - no hint
cuando vendras aqui - when you coming here - no hint
malo - little - no hint
me gusta el chocolate pero no me gusta el pastel - i like chocolate but i don39t like cake - no hint
su teléfono de nuevo - your phone again - no hint
el próximo año - next year - no hint
hoy tambien - also today - no hint
siempre cocina a las cinco en punto - always cooks at five o39clock - no hint
trabajar - to work - no hint
no puedo entender nada - i can not understand anything - no hint
viniendo a la oficina - coming to the office - no hint
tengo - have - no hint
a veces no puedo entenderte en absoluto - sometimes i can39t understand you at all - no hint
realmente existe - really exist - no hint
bebo café todas las mañanas - i drink coffee every morning - no hint
yendo a la tienda - going to the store - no hint
los - the - no hint
ningún libro - any book - no hint
vinimos ayer por la mañana - we came yesterday morning - no hint
mañana - morning - no hint
grande - great - no hint
mi hermana esta en la casa - my sister is in the house - no hint
recibir - to receive - no hint
cocineros - chefs - no hint
algo que quieras decir - anything you want to say - no hint
mirar y ver - look and see - no hint
no - no - no hint
te gusta el tenis - you like tennis - no hint
dónde - where - no hint
decir - tell - no hint
si - and - no hint
si vas - you are - no hint
aqui es mi primer dia - here is my first day - no hint
bien - well - no hint
primero - first - no hint
a menudo - often - no hint
pescar a menudo - fish often - no hint
he trabajado duro - i worked hard - no hint
toma el libro en el estante - take the book on the shelf - no hint
ellos quieren desayuno - they want breakfast - no hint
ellos quieren desayuno - they want breakfast - no hint
no azul - not blue - no hint
a veces tomar medicamentos es peligroso - sometimes taking medicine is dangerous - no hint
yendo a la tienda - going to the store - no hint
no tienes un buen auto - you don39t have a good car - no hint
saber - to know - no hint
no lo sé - i do not know - no hint
disfruta del tenis - enjoy tennis - no hint
su cabello es como la seda - her hair is like silk - no hint
me estas dando esto - are you giving me this - no hint
demasiado oscuro - too dark - no hint
rojo o blanco - red or white - no hint
cualquier chica - any girl - no hint
cuando aqui - when here - no hint
uso lentes porque tengo los ojos dañados - i wear glasses because my eyes are damaged - no hint
cuál libro - what book - no hint
esto no es mío - this is not mine - no hint
ha - ha - no hint
bebes una copa de vino tinto o blanco - you drink a glass of red or white wine - no hint
hora - hour - no hint
he trabajado - i have worked - no hint
la mujer tiene que trabajar el sábado - the woman has to work on saturday - no hint
mirar y ver son cosas diferentes - looking and seeing are different things - no hint
yo compré - i buy - no hint
gusta - like - no hint
hay algo que quiero decirte - there is something i want to tell you - no hint
sería mejor - it would be better - no hint
yo bebo café - i drink coffe - no hint
das - the - no hint
vamos - come on - no hint
no los conozco - i don39t know them - no hint
quieres - want - no hint
muy - very - no hint
con crema - with cream - no hint
día - day - no hint
cuando le gustaria hacer su cita - when would you like to make your appointment - no hint
hm - hm - no hint
su teléfono - your phone - no hint
muy frio por la noche - very cold at night - no hint
habla de tí - tell about you - no hint
seguro que puedes comerlo - sure you can eat it - no hint
que es esto - what is this - no hint
porqué es eso - why is that - no hint
realmente frio - really cold - no hint
le pregunté por qué se escapó - i asked him why he ran away - no hint
kim - kim - no hint
por qué te escapaste - why did you run away - no hint
cómo llegar allá - how to get there - no hint
entender - to understand - no hint
trabajar el sábado - work on saturday - no hint
es mejor que hagas deporte - you better do sports - no hint
queremos lápiz rojo no azul - we want red pencil not blue - no hint
bien - well - no hint
un dia soleado - a sunny day - no hint
tómalo sin olvidarlo - take it without forgetting it - no hint
haría cualquier cosa por mis hijos - i would do anything for my children - no hint
que - that - no hint
una buena amiga - a good friend - no hint
de verdad - really - no hint
alguna - some - no hint
quizás - maybe - no hint
antes de olvidar - before forget - no hint
no importa donde - it does not matter where - no hint
fácil de derribarlo - easy to tear it down - no hint
sin explicar eso - without explaining that - no hint
a menudo salgo a pescar - i often go fishing - no hint
allí ahora - there now - no hint
aquí - here - no hint
soy feliz cuando el clima esta soleado - i am happy when the weather is sunny - no hint
todas las tiendas están cerradas ahora - all stores are closed now - no hint
cuando - when - no hint
mi hermano y hermana - my brother and sister - no hint
qué - that - no hint
o - o - no hint
de quien - whose - no hint
sobre - on - no hint
ser - to be - no hint
para - for - no hint
cuales - which - no hint
comer su comida - eat their food - no hint
incluso un maestro - even a teacher - no hint
esto y aquello - this and that - no hint
eh - eh - no hint
como ir - how to go - no hint
tal vez llueva - maybe it will rain - no hint
pero no me gusta el pastel - but i don39t like cake - no hint
hm ahora - hm now - no hint
comí demasiado - i ate too much - no hint
dónde - where - no hint
y - and - no hint
mi hermano y mi hermana son doctores - my brother and sister are doctors - no hint
cuando tomar - when to drink - no hint
solo - only - no hint
si te vas yo también iré - if you go i will go too - no hint
cuánto comiste - how much did you eat - no hint
cuando esta soleado - when it39s sunny - no hint
de quien escuchaste esto - who did you hear this from - no hint
porqué - because - no hint
que libro leíste - what book did you read - no hint
ser - to be - no hint
incluso el maestro llega tarde - even the teacher is late - no hint
por supuesto - of course - no hint
nacido - born - no hint
todas las tiendas - all stores - no hint
con - with - no hint
sin pagarlo - without paying it - no hint
ama - but - no hint
los - the - no hint
seguro voluntad - sure will - no hint
acerca de ti mismo - about yourself - no hint
todos - everybody - no hint
cómo - excuse me - no hint
usar - to use - no hint
hora - hour - no hint
verdadero - true - no hint
cerca - search for - no hint
episodio - episode - no hint
debajo - under - no hint
caso - case - no hint
ciudad - city - no hint
árbol - tree - no hint
excitar - excite - no hint
vida - life - no hint
ciencias - sciences - no hint
comida - meal - no hint
su amigo - his friend - no hint
empezado - started - no hint
letra - letter - no hint
usual - usual - no hint
mundo - world - no hint
esperanza - hope - no hint
oficina - office - no hint
hecho - done - no hint
adán - adam - no hint
a mi - a mi - no hint
frase - phrase - no hint
diferente - different - no hint
allí - there - no hint
escribir - to write - no hint
largo - length - no hint
cosa - thing - no hint
leche - milk - no hint
dónde - where - no hint
detrás - behind - no hint
puede ser - can be - no hint
colegio - school - no hint
crecer - grow - no hint
sol - sun - no hint
cuatro - four - no hint
expresar - express - no hint
siglo - century - no hint
correr - run - no hint
noche - night - no hint
norte - north - no hint
peligro - danger - no hint
fruta - fruit - no hint
habitación - bedroom - no hint
grueso - thick - no hint
juntos - together - no hint
próximo - next - no hint
muestra - sample - no hint
ferrocarril - railway - no hint
kilómetro - kilometer - no hint
mantenimiento - maintenance - no hint
derecho - right - no hint
muchacha - girl - no hint
afilado - sharp - no hint
recibir - to receive - no hint
sitio - site - no hint
tam - tam - no hint
morir - to die - no hint
entonces - then - no hint
sesión - session - no hint
año - year - no hint
llegó - arrive - no hint
dama - lady - no hint
nombre de pila - first name - no hint
formulario - form - no hint
confundir - confuse - no hint
posee - has - no hint
jardín - yard - no hint
derecho - right - no hint
niño - kid - no hint
ese - that - no hint
otro - other - no hint
en bancarrota - bankrupt - no hint
lunes - monday - no hint
escala - scale - no hint
nación - nation - no hint
pago - pay - no hint
vestido - dress - no hint
llamada - call - no hint
yan - yan - no hint
metal - metal - no hint
trabaja - works - no hint
comida - meal - no hint
sostuvo - held - no hint
pelo - fur - no hint
cocinero - cook - no hint
suelo - floor - no hint
ojo - eye - no hint
nunca - never - no hint
cruzar - cross - no hint
granja - farm - no hint
mar - sea - no hint
dibujar - to draw - no hint
tarde - late - no hint
dedo - finger - no hint
el valor de - the value of - no hint
prensa - press - no hint
mentir - to lie - no hint
ganó - won - no hint
la - the - no hint
vista - sight - no hint
silla - chair - no hint
idea - idea - no hint
difícil - hard - no hint
separar - break apart - no hint
oír - hear - no hint
a - a - no hint
de madera - of wood - no hint
madre - mother - no hint
abierto - open - no hint
cuyo - whose - no hint
muestra - sample - no hint
su - it's - no hint
sueño - dream - no hint
pies - feet - no hint
tipo - kind - no hint
necesario - necessary - no hint
joven - young man - no hint
listo - ready - no hint
sobre - on - no hint
rojo - red - no hint
cerrado - closed - no hint
nosotros - we - no hint
flor - flower - no hint
negocio - business - no hint
línea - line - no hint
de todas formas - anyway - no hint
boca - mouth - no hint
símbolo - symbol - no hint
viva - alive - no hint
problema - issue - no hint
espalda - back - no hint
descanso - break - no hint
patio - patio - no hint
se levantará - will stand up - no hint
golpe - knock - no hint
petróleo - petroleum - no hint
por ciento - percent - no hint
pensar - to think - no hint
decir - tell - no hint
ayuda - help - no hint
bajo - under - no hint
marrón - brown - no hint
usar - to use - no hint
regreso - return - no hint
porqué es eso - why is that - no hint
selección - selection - no hint
justa - fair - no hint
viejo - old - no hint
mismo - same - no hint
control - control - no hint
ellos - they - no hint
haría - would do - no hint
consonante - consonant - no hint
velocidad - speed - no hint
edad - age - no hint
la gente - people - no hint
no - no - no hint
gente - people - no hint
sólo yo - just me - no hint
sobre - on - no hint
planchar - iron - no hint
único - unique - no hint
kim - kim - no hint
sonreír - smile - no hint
sucedió - it happened - no hint
arrugado - wrinkled - no hint
cabeza - head - no hint
página - page - no hint
deber - have to - no hint
fue encontrado - it was found - no hint
respuesta - answer - no hint
resolver - sort out - no hint
eso - that - no hint
todavía - yet - no hint
aprender - learn - no hint
planta - plant - no hint
cubrir - cover - no hint
mantener - keep - no hint
resultado - result - no hint
quemadura - burn - no hint
dejar - let - no hint
tipos - types - no hint
ley - law - no hint
difícil - hard - no hint
comienzo - start - no hint
costa - costa - no hint
padrino - godfather - no hint
sol - sun - no hint
rollo - roll - no hint
natural - natural - no hint
sentido - sense - no hint
libro - book - no hint
cogí - i took - no hint
rico - rico - no hint
soldado - soldier - no hint
proceso - process - no hint
montaña - mountain - no hint
por favor - please - no hint
reloj - watch - no hint
color - color - no hint
rostro - face - no hint
estudiante - student - no hint
esquina - corner - no hint
parecer - seem - no hint
alimentar - to feed - no hint
sitio - site - no hint
blanco - white - no hint
periodo de - period of - no hint
facilidad de - ease of - no hint
papel - paper - no hint
eso - that - no hint
el efecto de - the effect of - no hint
río - river - no hint
auto - auto - no hint
segundo - second - no hint
kanat - kanat - no hint
vecino - neighbour - no hint
murciélago - bat - no hint
en lugar de - instead of - no hint
lista - ready - no hint
pronto - early - no hint
tierra - land - no hint
tipo - kind - no hint
pasado - last - no hint
hogar - home - no hint
tratar - deal - no hint
aire - air - no hint
sí - yes - no hint
punto - point - no hint
contento - happy - no hint
propio - own - no hint
partera - midwife - no hint
viaje - travel - no hint
redondo - round - no hint
semilla - seed - no hint
unirse - join - no hint
show - show - no hint
ha crecido - has grown - no hint
teléfono - telephone - no hint
costo - cost - no hint
perdió - lost - no hint
igual - same - no hint
enviado - sent - no hint
asi que - so - no hint
cayó - it fell - no hint
apropiado - appropriate - no hint
movimiento - movement - no hint
fluir - flow - no hint
banco - bank - no hint
recoger - collect - no hint
oído - hearing - no hint
bastante - quite - no hint
camino - road - no hint
hijo - son - no hint
muchos - many - no hint
alto - high - no hint
bahar - bahar - no hint
como - what - no hint
élellaeso - him that - no hint
diccionario - dictionary - no hint
nube - cloud - no hint
sorpresa - surprise - no hint
tranquilo - calm - no hint
yo hice - i did - no hint
frio - cold - no hint
diseño - design - no hint
llave - key - no hint
mayo - may - no hint
abajo - down - no hint
piel - skin - no hint
agujero - hole - no hint
encontrar - meet - no hint
saltar - skip - no hint
estar - to be - no hint
propio - own - no hint
encontrarse - meet - no hint
aumentar - increase - no hint
párrafo - paragraph - no hint
tercera - third - no hint
definir - define - no hint
entre - come in - no hint
sí - yes - no hint
cerro - closed - no hint
idea - idea - no hint
gato - cat - no hint
copiar - copy - no hint
historia - history - no hint
sierra - sierra - no hint
transporte - transport - no hint
el pez - the fish - no hint
funcionar - function - no hint
solicitud - request - no hint
base - base - no hint
corte - court - no hint
por supuesto - of course - no hint
contemporáneo - contemporary - no hint
anillo - ring - no hint
personaje - character - no hint
comienzo - start - no hint
insecto - insect - no hint
caminar - to walk - no hint
radio - radio - no hint
grupo - group - no hint
es el átomo - is the atom - no hint
música - song - no hint
electricidad - electricity - no hint
elegante - elegant - no hint
hueso - bone - no hint
estoy de acuerdo - i agree - no hint
mujer - woman - no hint
creo - i think - no hint
lavado - washed - no hint
no - no - no hint
aunque - even though - no hint
sentir - to feel - no hint
discusión - discussion - no hint
pájaro - bird - no hint
campana - campaign - no hint
cuerpo - body - no hint
magia - magic - no hint
incluso - even - no hint
tabla de - table of - no hint
alegría - joy - no hint
semejante - similar - no hint
reloj - watch - no hint
pedir - ask for - no hint
cambio - change - no hint
suave - gentle - no hint
brillante - shiny - no hint
fotografía - photography - no hint
gas - gas - no hint
otra vez - again - no hint
animal - animal - no hint
finalizar - finalize - no hint
construcción - construction - no hint
vestirse - get dressed - no hint
tierra - land - no hint
desaparecido - missing - no hint
comercio - trade - no hint
gritar - shout out - no hint
escribió - wrote - no hint
limpio - cleansed - no hint
no tocar - do not touch - no hint
equipo - team - no hint
ahorrar - save money - no hint
decimal - decimal - no hint
medio - half - no hint
matar - kill - no hint
lago - the needle - no hint
para observar - to observe - no hint
a - a - no hint
organo - organ - no hint
roca - stone - no hint
su numero - on number - no hint
su - it's - no hint
trepar - screw - no hint
sopa - soup - no hint
bebé - baby - no hint
ocho - eight - no hint
bahía - bay - no hint
cocina - kitchen - no hint
país - country - no hint
comprar - purchase - no hint
tengo tiempo la semana que viene - i have time next week - no hint
siete - seven - no hint
un poco - a little - no hint
expresión - expression - no hint
lucha - struggle - no hint
de ninguna manera - no way - no hint
difícil - hard - no hint
doctor - doctor - no hint
proteger - to protect - no hint
mediodía - midday - no hint
recorte - cutout - no hint
obrero - worker - no hint
activar - activate - no hint
atrapó - caught - no hint
habló - speak - no hint
historia de - history of - no hint
signo - sign - no hint
estamos esperando - we are waiting - no hint
capitán - captain - no hint
suficiente - enough - no hint
egipto - egypt - no hint
cuerda - rope - no hint
perro - dog - no hint
paso - he passed - no hint
amor - love - no hint
regla - rule - no hint
frío - cold - no hint
poner - put - no hint
deseo - desire - no hint
escrito - written - no hint
instrumento - instrument - no hint
césped - grass - no hint
vaca - cow - no hint
hombres - mens - no hint
necesitar - need - no hint
millón - million - no hint
melodía - melody - no hint
método - method - no hint
diminuto - tiny - no hint
juicio - judgment - no hint
todo - all - no hint
veinte - twenty - no hint
a salvo - safe - no hint
la temperatura - the temperature - no hint
proveer - provide - no hint
por lo tanto - thus - no hint
poesía - poetry - no hint
conectado - connected - no hint
pulgada - inch - no hint
neumático - tire - no hint
pintura - painting - no hint
bala - bala - no hint
llorar - mourn - no hint
detenido - stopped - no hint
incluso - even - no hint
oh - oh - no hint
rápido - quick - no hint
recuerdo - memory - no hint
especialmente - especially - no hint
guerra - war - no hint
molécula - molecule - no hint
persona - person - no hint
para - for - no hint
aparece - appear - no hint
sal - salt - no hint
enojo - anger - no hint
noticias - news - no hint
alegación - allegation - no hint
tocar - to touch - no hint
solamente - only - no hint
leyendo - reading - no hint
puerto - port - no hint
captura - capture - no hint
agregar - add - no hint
cielo - sky - no hint
aquí - here - no hint
salvaje - wild - no hint
conocido - known - no hint
borde - should - no hint
soportar - bear - no hint
extraño - strange - no hint
mayo - may - no hint
deberá - shall - no hint
atestado - attestation - no hint
articulo - article - no hint
pasar - market - no hint
ya que - as - no hint
cima - up - no hint
calle - street - no hint
llegar - reach - no hint
protuberancia - boss - no hint
lección - lesson - no hint
trajo - brought - no hint
delgado - slim - no hint
solución - solution - no hint
máquina - machine - no hint
caja - box - no hint
manzana - apple - no hint
banda - band - no hint
deslizar - slide - no hint
desarrollar - develop - no hint
he oído - i have heard - no hint
cinco - five - no hint
temprano - early - no hint
tabaco - tobacco - no hint
verbo - verb - no hint
escucha - listens - no hint
derecho - right - no hint
dibujo - he drew - no hint
central - central - no hint
columna - column - no hint
seleccione - select - no hint
mapa - map - no hint
administración - management - no hint
plural - plural - no hint
continente - continent - no hint
además - what39s more - no hint
el verano - summer - no hint
probar - taste - no hint
pierna - leg - no hint
ejercicio - exercise - no hint
el - the - no hint
invierno - winter - no hint
ligero - light - no hint
visitar - to visit - no hint
divertido - funny - no hint
no tengo tiempo para esto - i do not have time for this - no hint
directo - direct - no hint
tubo - tube - no hint
rakam - rakam - no hint
asi que - so - no hint
él sabía - he knew - no hint
maestro - teacher - no hint
quédate - stay - no hint
objeto - object - no hint
superficie - surface - no hint
sistema - system - no hint
registro - record - no hint
bote - world - no hint
posible - possible - no hint
de alguien más - someone else - no hint
soy - am - no hint
caliente - hot - no hint
me perdí - i got lost - no hint
hablar - speak - no hint
traer - to bring - no hint
sí - yes - no hint
pueblo - town - no hint
muerte - death - no hint
otoño - fall - no hint
agradecer - to thank - no hint
calificación - qualification - no hint
espere - wait - no hint
plan - plan - no hint
estrella - star - no hint
tiene miedo - he is afraid - no hint
talentoso - talented - no hint
se acabó - it39s over - no hint
conductor - conductor - no hint
usted - you - no hint
enseñar - to teach - no hint
semana - week - no hint
verde - green - no hint
libre - free - no hint
detrás - behind - no hint
espacio - space - no hint
seguir - follow continue - no hint
cuadra - block - no hint
momento - moment - no hint
evento - event - no hint
contrato - contract - no hint
nadar - to swim - no hint
interesar - interest - no hint
llegar - reach - no hint
arreglar - fix - no hint
canción - song - no hint
invención - invention - no hint
seis - six - no hint
viaje - travel - no hint
nueve - nine - no hint
sencillo - simple - no hint
unos pocos - a few - no hint
famoso - famous - no hint
tirar a la basura - throw away - no hint
lento - slow - no hint
propiedad - property - no hint
servicio - service - no hint
gris - grey - no hint
requiere - requires - no hint
grande - great - no hint
lluvia - rain - no hint
preparar - prepare - no hint
controlar - control - no hint
energía - energy - no hint
navegar - surf - no hint
dilo - dilo - no hint
quiero - i want - no hint
raza - race - no hint
ventana - window - no hint
tren - train - no hint
pared - wall - no hint
cts - cts - no hint
no tan bueno como dijo - not as good as said - no hint
producto - product - no hint
negro - black - no hint
pequeño - little - no hint
planeta - planet - no hint
clase - class - no hint
pregunta - question - no hint
sería - would - no hint
embarcacion - boat - no hint
mi amor - my love - no hint
fresco - fresh - no hint
buscar - search - no hint
orden - order - no hint
sur - sure - no hint
pedazo - piece - no hint
desierto - desert - no hint
desde - since - no hint
rueda - wheel - no hint
lámina - sheet - no hint
importar - to import - no hint
fuerza - force - no hint
azul - blue - no hint
correo - mail - no hint
gastar - to spend - no hint
profundo - deep - no hint
pie - pie - no hint
parte de - part of - no hint
estación - station - no hint
ocupado - occupied - no hint
prueba - proof - no hint
cargo - position - no hint
pareja - partner - no hint
oro - oro - no hint
licitación - bidding - no hint
plano - flat - no hint
esclavo - slave - no hint
preguntarse - wonder - no hint
reír - to laugh - no hint
grado de - grade of - no hint
llenar - fill - no hint
control - control - no hint
juego - play - no hint
figura - figure - no hint
bebida - drink - no hint
ocurrir - occur - no hint
apoyo - support for - no hint
calor - hot - no hint
líquido - liquid - no hint
lejos - far - no hint
llenar - fill - no hint
este - it is - no hint
diente - tooth - no hint
poder - can - no hint
hermosa - beautifull - no hint
específico - specific - no hint
mosca - moscow - no hint
rama - raman - no hint
sonek - sonek - no hint
debate - debate - no hint
libra - books - no hint
similar - similar - no hint
guía - guide - no hint
belleza - beauty - no hint
punto - point - no hint
abrió - opened - no hint
tono - tone - no hint
dio - it gave - no hint
halat - halat - no hint
oceano - ocean - no hint
noche - night - no hint
fuerte - strong - no hint
mente - mind - no hint
básico - basic - no hint
vadi - vadi - no hint
cola - tail - no hint
grafico - graphic - no hint
sombrero - hat - no hint
oeste - west - no hint
su esposa - his wife - no hint
hombro - shoulder - no hint
irradiar - radiate - no hint
gráfico - graphic - no hint
nacido - born - no hint
determinar - decide - no hint
sabah - sabah - no hint
camión - truck - no hint
ruido - noise - no hint
oportunidad - chance - no hint
tienda - shop - no hint
tramo - section - no hint
brillo - brightness - no hint
falso - fake - no hint
nariz - nose - no hint
dicho - saying - no hint
dormir - to sleep - no hint
puedo tener una bolsita por favor - can i have a bag please - no hint
uno de esto por favor - one of this please - no hint
si tienes algo que decir dilo - if you have something to say say it - no hint
familia - family - no hint
dejalo - leave it alone - no hint
para medir - to measure - no hint
puerta - door - no hint
opinión - opinion - no hint
aquellos - those - no hint
cabeza - head - no hint
viento - wind - no hint
colonia - suburb - no hint
mayo - may - no hint
completo - full - no hint
corbata - tie - no hint
fuego - fire - no hint
pistola - gun - no hint
permiso - excuse me - no hint
actual - actual - no hint
todos - everybody - no hint
rey - king - no hint
padre - dad - no hint
favor - favor - no hint
conectar - connect - no hint
acorde - chord - no hint
gordo - fat - no hint
hay - there are - no hint
bar - bar - no hint
segmentos - segments - no hint
cuál - which one - no hint
instante - instant - no hint
mercado - market - no hint
polluelo - chick - no hint
enemigo - enemy - no hint
naturaleza - nature - no hint
kar - kar - no hint
vapor - vapor - no hint
iniciar sesión - log in - no hint
el corazón - the heart - no hint
unidad - unit - no hint
oxígeno - oxygen - no hint
caramelo - candy - no hint
oscuro - dark - no hint
partido - match - no hint
dominio - domain - no hint
chaqueta - jacket - no hint
final - final - no hint
masa - time - no hint
victoria - victoria - no hint
minuto - minute - no hint
nutrir - nourish - no hint
herramienta - tool - no hint
especial - special - no hint
koku - koku - no hint
para producir - to produce - no hint
sillón - armchair - no hint
expulsar - expel - no hint
contra - against - no hint
zapato - shoe - no hint
partido - match - no hint
nivel - level - no hint
sobre - on - no hint
otro - other - no hint
posición - position - no hint
columna - column - no hint
no - no - no hint
tres - three - no hint
sentarse - feel - no hint
cuántos grados - how many degrees - no hint
iré al cine este fin de semana - i will go to the cinema this weekend - no hint
qué haces este fin de semana - what are you doing this weekend - no hint
quieres bailar - you want to dance - no hint
no fui yo - was not me - no hint
se llevaron mi teléfono - they took my phone - no hint
mi suerte ha aumentado - my luck has increased - no hint
nada grande - nothing big - no hint
besar - big - no hint
miedo - afraid - no hint
triángulo - triangle - no hint
ingresar - enterokay - no hint
enviar - submit - no hint
amarillo - yellow - no hint
dijo - he said - no hint
ascensor - elevator - no hint
rosa - pink - no hint
división - division - no hint
satisfecho - satisfied - no hint
original - original - no hint
pan - pan - no hint
pato - duck - no hint
el corrió - he ran - no hint
estimado - estimated - no hint
cascarón - shell - no hint
cuello - neck - no hint
habilidad - ability - no hint
temporada - season - no hint
imán - magnet - no hint
plata - the payment - no hint
higo - fig - no hint
hermano - brother - no hint
acero - steel - no hint
más lejos - further away - no hint
experiencia - experience - no hint
mapa - map - no hint
sueño - dream - no hint
estado - condition - no hint
total - total - no hint
nacido - born - no hint
doble - double - no hint
éxito - success - no hint
durante - during - no hint
empresa - business - no hint
algodón - cotton - no hint
cuarto de galón - quart - no hint
caja - box - no hint
todavía - yet - no hint
material bélico - war material - no hint
fracción - fraction - no hint
colocar - put on - no hint
bosque - forest - no hint
cuáles son tus aficiones - what are your hobbies - no hint
es esta tu primera vez que vienes a nosotros - is this your first time you come to us - no hint
lo siento - sorry - no hint
qué tal - how are you - no hint
usted es tan guapo - you are so handsome - no hint
me lo estoy pasando genial - i39m having a great time - no hint
perdió sus llaves - lost his keys - no hint
aquí está mi información de contacto - here is my contact information - no hint
que es eso - what is that - no hint
que es esto - what is this - no hint
te lo merecías - you deserved it - no hint
qué estás haciendo aquí - what are you doing here - no hint
ten cuidado - beware - no hint
estoy cien por ciento seguro - i am one hundred percent sure - no hint
soy tímido - i39m shy - no hint
estaba muy avergonzado - i was very embarrassed - no hint
carne - meat - no hint
dólar - dollar - no hint
fluir - flow - no hint
impresión - print - no hint
gama de - range of - no hint
ola - be - no hint
hacer - do - no hint
eres muy considerado - you are very considerate - no hint
tienes una cita - you have a date - no hint
disculpe estamos llenos - excuse me we are full - no hint
nosotros te llamaremos - we will call you - no hint
el agua está demasiado fría - the water is too cold - no hint
tarda entre tres y cinco días laborables - takes three to five business days - no hint
puedo obtener una explicación por favor - can i get an explanation please - no hint
esta cuenta tiene una tarifa anual - this account has an annual fee - no hint
va a nevar el viernes - it39s going to snow on friday - no hint
mañana estará soleado y lluvioso - tomorrow will be sunny and rainy - no hint
cómo estuvo tu día - how was your day - no hint
que hay para cenar - what39s for dinner - no hint
por favor perdóname - please forgive me - no hint
tarjeta de memoria - memory card - no hint
hola - hello - no hint
buenos días - good morning - no hint
cuántos años tienes - how old are you - no hint
bienvenido - welcome - no hint
una vez más por favor - one more time please - no hint
no entiendo - i do not understand - no hint
he cambiado - i have changed - no hint
no lo volveré hacer - i will not do it again - no hint
estas listo para empezar - are you ready to start - no hint
te quiero - i love you - no hint
era mi bolso - it was my bag - no hint
necesito un médico - i need a doctor - no hint
llame a la policía - call the police - no hint
tienes alguna identificación - do you have any identification - no hint
sigo pensando en ella - i keep thinking about her - no hint
muerto - dead - no hint
peso - weight - no hint
tenía - i had - no hint
cima - up - no hint
corazón - heart - no hint
disponible - available - no hint
será - it will be - no hint
motor - motor - no hint
estar aquí antes del mediodía - be here before noon - no hint
lo siento por su pérdida - sorry for your loss - no hint
puedo traerte algo de beber - can i get you something to drink - no hint
no deberías haberlo hecho - you shouldn39t have - no hint
me siento enfermo - i feel sick - no hint
a donde quieres ir - where do you want to go - no hint
te lo dejo a tí - i leave it to you - no hint
te ha gustado - did you like it - no hint
estoy buscando este lugar - i39m looking for this place - no hint
quiero retirar dinero - i want to withdraw money - no hint
regresa - came back - no hint
tengo tos - i have a cough - no hint
ya levantado - already up - no hint
como dos semanas - like two weeks - no hint
me quedaré en el hotel central - i will stay at the central hotel - no hint
hace calor en los veranos - it39s hot in the summers - no hint
se acerca una tormenta - a storm is coming - no hint
cuál es tu número de teléfono - what is your phone number - no hint
sentirse como en casa - feel like home - no hint
es difícil - it39s hard - no hint
hubo un accidente automovilístico - there was a car accident - no hint
puedo tener un recibo por favor - can i have a receipt please - no hint
gracias a todos - thanks to all - no hint
no puedo hacer esto - i can not do this - no hint
general - general - no hint
circulo - circle - no hint
en - in - no hint
sintió - he felt - no hint
escucho - i39m listening - no hint
qué haces en tu tiempo libre - what do you do in your free time - no hint
felicitaciones - congratulations - no hint
bienvenido - welcome - no hint
puedes venir de nuevo mas tarde - you can come again later - no hint
se ve muy bien - looks great - no hint
quiero cambiar dinero - i want to change money - no hint
quiero hacer un deposito - i want to make a deposit - no hint
quiero abrir una cuenta - i want to open an account - no hint
duele - hurts - no hint
hay algún problema - is there a problem - no hint
estoy aquí para una visita familiar - i am here for a family visit - no hint
estoy aqui por trabajo - i39m here for work - no hint
habrá fuertes lluvias por la noche - there will be heavy rain at night - no hint
lloverá por la tarde - it will rain in the afternoon - no hint
llovió todo el día - it rained all day - no hint
donde está todo el mundo - where is everybody - no hint
gracias - thank you - no hint
adiós - goodbye - no hint
cuánto tiempo hace que no nos reunimos - how long has it been since we met - no hint
estupendo - great - no hint
delicioso - delicious - no hint
me gusta - i like - no hint
no me gusta - dislike - no hint
qué hora es - what time is it - no hint
bueno - okay - no hint
de verdad - really - no hint
de dónde eres - where are you from - no hint
esto es para ti - this is for you - no hint
más lento por favor - slower please - no hint
cuarto - room - no hint
ellos - they - no hint
palabra - word - no hint
porque - because - no hint
dividir - share - no hint
sílaba - syllable - no hint
pesado - heavy - no hint
mediodía - midday - no hint
a que hora es buena para ti - what time is good for you - no hint
tienes hijos - have children - no hint
soy estadounidense - i am american - no hint
te vas de vacaciones - you go on holiday - no hint
te ves genial - you look great - no hint
quiero ir aquí - i want to go here - no hint
tengo dolor de estómago - i have a stomach ache - no hint
tengo fiebre - i have a fever - no hint
has estado aquí antes - have you been here before - no hint
mañana estará soleado - it will be sunny tomorrow - no hint
como esta el clima en invierno - how is the weather in winter - no hint
habrá tormentas eléctricas por la noche - there will be thunderstorms at night - no hint
muy buen día - very good day - no hint
entonces hay algo nuevo - then there is something new - no hint
a donde fuiste hoy - where you went today - no hint
qué vas a hacer mañana - what are you going to do tomorrow - no hint
no te preocupes - do not worry - no hint
buenas noches - good evening - no hint
estoy bien - i39m good - no hint
elegir - to choose - no hint
años - years - no hint
y - and - no hint
talla - size - no hint
establecerse - settle - no hint
par - by - no hint
vamos en veinte minutos - let39s go in twenty minutes - no hint
podemos irnos como seis - we can go like six - no hint
son las tres en punto - it39s three o39clock - no hint
no tengo dinero - i do not have money - no hint
alo - alo - no hint
encantado de conocerte - pleased to meet you - no hint
huevo - egg - no hint
celda - cell - no hint
largo - length - no hint
representación - representation - no hint
región - region - no hint
pero - but - no hint
cambio - change - no hint
algunos - some - no hint
es eso - is that - no hint
pasado mañana es viernes - the day after tomorrow is friday - no hint
al parecer tardará unos treinta minutos más en llegar allí - apparently it will take about thirty more minutes to get there - no hint
el se va ahora - he is leaving now - no hint
has hecho esto antes - have you done this before - no hint
probable - probable - no hint
cama - bed - no hint
subirse - get on - no hint
yo creo - i think - no hint
posee - has - no hint
ser - to be - no hint
hay un malentendido - there is a misunderstanding - no hint
ya el domingo - already sunday - no hint
termina en treinta minutos - ends in thirty minutes - no hint
el avión llegará por la noche - the plane will arrive at night - no hint
como - what - no hint
arte - art - no hint
por - by - no hint
hielo - ice - no hint
habla usted inglés - do you speak english - no hint
como podemos arreglar esto - how can we fix this - no hint
voy - go - no hint
no hay papel higiénico - there is no toilet paper - no hint
la televisión no funciona - the tv does not work - no hint
a que hora es el desayuno - what time is breakfast - no hint
tengo una reservación - i have a reservation - no hint
solo martes - only tuesday - no hint
serán como las siete de la tarde aquí - it will be like seven in the afternoon here - no hint
llegaremos treinta minutos antes - we will arrive thirty minutes before - no hint
cazar - hunt - no hint
contar - tell - no hint
sujeto - subject - no hint
hablar - speak - no hint
una mesa para cinco - a table for five - no hint
al otro lado de la calle de la biblioteca - across the street from the library - no hint
me pregunto si tienes reserva - i wonder if you have a reservation - no hint
me pregunto cuantas personas - i wonder how many people - no hint
que día es hoy - what day is today - no hint
nos vamos a encontrar con alguien - we are going to meet someone - no hint
cómo eran ellos - what we're they like - no hint
puedo hacer una llamada - can i make a call - no hint
llámame si necesitas algo - call me if you need anything - no hint
necesitas algo - you need something - no hint
estaré de vuelta esta noche - i will be back tonight - no hint
hoy es miercoles - today is wednesday - no hint
llevaba una camisa roja de bitcoin y jeans - he wore a red bitcoin shirt and jeans - no hint
el lunes es el peor día de la semana - monday is the worst day of the week - no hint
soy alérgico a los camarones - i am allergic to shrimp - no hint
comí demasiado - i ate too much - no hint
qué le gustaría beber - what would you like to drink - no hint
tokum - tokum - no hint
cuánto cuesta este - how much is this - no hint
tomaré este - i will take this - no hint
por favor siéntate - please sit down - no hint
lo mismo para mi - the same for me - no hint
cuanto se necesita - how much is needed - no hint
es asi - it39s like that - no hint
que tipo de comida es esta - what kind of food is this - no hint
sabes dónde está este lugar - do you know where this place is - no hint
está abierta la piscina hoy - the pool is open today - no hint
qué quieres comer - what do you want to eat - no hint
realmente bueno - really good - no hint
a dónde vamos - where we go - no hint
puedo tomar un poco de leche - can i have some milk - no hint
cuenta - bill - no hint
girar a la izquierda en el segundo semáforo - turn left at the second traffic light - no hint
suena genial - sounds great - no hint
las flores están floreciendo - the flowers are blooming - no hint
quieres ir a dar una vuelta - would you like to go out - no hint
te gusta el fútbol - do you like football - no hint
por favor escribe - please write - no hint
por favor espere un minuto - please wait a minute - no hint
para aquí por favor - stop here please - no hint
no puedo conectarme a internet - i can39t connect to the internet - no hint
a donde quieres ir - where do you want to go - no hint
espera un minuto por favor - wait a minute please - no hint
lo intentaré de nuevo más tarde - will try again later - no hint
casi llegamos - we almost arrive - no hint
parece que no quiero ir - i don39t seem to want to go - no hint
muy triste - very sad - no hint
duele - hurts - no hint
puedo sentarme aquí - i can sit here - no hint
qué color - what color - no hint
se siente muy triste - it feels very sad - no hint
creo que puedes hacerlo - i think you can do it - no hint
casi lo hago - i almost do it - no hint
definitivamente no es gracioso - definitely not funny - no hint
me siento tan triste cuando pienso en el - i feel so sad when i think of him - no hint
no me siento bien - i do not feel well - no hint
se - i know - no hint
estoy preocupado - i39m worried - no hint
estoy de mal humor - i39m in a bad mood - no hint
estoy realmente nervioso - i39m really nervous - no hint
déjame en paz - leave me alone - no hint
a usted no le incumbe - it is not your concern - no hint
bueno en realidad no lo sé tan bien - well i don39t really know that well - no hint
no tienes coche - you don39t have a car - no hint
para mamá y papá - for mom and dad - no hint
esto y aquello por favor - this and that please - no hint
los - the - no hint
parecer - seem - no hint
año - year - no hint
sí - yes - no hint
no toques el mal de ojo - don39t touch the evil eye - no hint
yo no digo - i do not say - no hint
tengo que darme una ducha rápida ahora - i have to take a quick shower now - no hint
el único - the only - no hint
crear - create - no hint
tener miedo de - to be afraid of - no hint
quien lo entiende - who understands - no hint
estoy asustado - i am scared - no hint
considerable - considerable - no hint
dormir - to sleep - no hint
tipo - kind - no hint
ducha - shower - no hint
no podemos ir sin pagar esto - we can39t go without paying this - no hint
avión - airplane - no hint
lejos - far - no hint
acuerdo - agreement - no hint
temprano - early - no hint
jugador - player - no hint
el sultán lo hizo - the sultan did - no hint
costoso - expensive - no hint
dolorido - sore - no hint
sal - shall - no hint
de dónde eres - where are you from - no hint
fue difícil pero lo logramos - it was difficult but we made it - no hint
ser despiadado es una elección - being ruthless is a choice - no hint
toco la guitarra - i play the guitar - no hint
por favor ven antes del mediodía - please come before noon - no hint
en internet - in internet - no hint
televisión - tv - no hint
taxi - taxi - no hint
tren - train - no hint
tu foto - your photo - no hint
caramelo - candy - no hint
programador - programmer - no hint
zamir - zamir - no hint
excepto - except - no hint
sí - yes - no hint
ruso - russian - no hint
vendedor - seller - no hint
algunos - some - no hint
mi discurso - my speech - no hint
la mayoría de - most of - no hint
lindo - pretty - no hint
sediento - thirsty - no hint
artista - artist - no hint
capital - capital - no hint
en américa durante muchos años pero antes de que escocia daben - in america for many years but before scotland daben - no hint
muchacha - girl - no hint
zapato - shoe - no hint
generelikle - generelikle - no hint
cálido - warm - no hint
laboral - labor - no hint
comida - meal - no hint
promesa - promise - no hint
llave - key - no hint
tabaco - tobacco - no hint
bolso - bag - no hint
pobre - poor - no hint
falso - fake - no hint
no te rindas - do not give up - no hint
falso - fake - no hint
gerente - manager - no hint
cansado - tired - no hint
relajante - relaxing - no hint
psicológico - psychological - no hint
me tragué la pastilla ahora - i swallowed the pill now - no hint
industria - industry - no hint
tranquilo - calm - no hint
trabajar - to work - no hint
único - unique - no hint
limpio - cleansed - no hint
en - in - no hint
consejo - tip - no hint
porque mis ojos estan rotos - because my eyes are broken - no hint
lino - linen - no hint
no puedo ir a ningún lado sin explicar eso - i can39t go anywhere without explaining that - no hint
usar - to use - no hint
prepara el cordero sin derramarlo - prepare the lamb without spilling it - no hint
carne de cordero - mutton - no hint
mitad - half - no hint
se encuentra - it39s found - no hint
gratis - free - no hint
no importa - no matter - no hint
auto - auto - no hint
pollo - chicken - no hint
el cliente viene a la oficina - the client comes to the office - no hint
cómico - funny - no hint
computadora - computer - no hint
cocinero - cook - no hint
pequeño - little - no hint
todavía - yet - no hint
establecer - set up - no hint
la evolución humana continúa durante miles de años - human evolution continues for thousands of years - no hint
no podría decir - i could not say - no hint
emperador - emperor - no hint
copa - cup - no hint
el pez - the fish - no hint
ropa - clothing - no hint
débil - weak - no hint
vaya - wow - no hint
pecho - chest - no hint
sol - sun - no hint
hermosa - beautifull - no hint
dinámico - dynamic - no hint
industria - industry - no hint
minuto - minute - no hint
triste - sad - no hint
recordar - remind - no hint
motivo - reason - no hint
recuerdas - remember - no hint
ya - yes - no hint
pero - but - no hint
siguiente - following - no hint
enfermera - nurse - no hint
pantalones - pants - no hint
brillante - shiny - no hint
ventoso - windy - no hint
presidente - president - no hint
claro - sure - no hint
cerveza - beer - no hint
tienda - shop - no hint
en el examen - in the exam - no hint
tienda - shop - no hint
tarjeta de crédito - credit card - no hint
profesor - teacher - no hint
postre - dessert - no hint
todos - everybody - no hint
hambre - hungry - no hint
bueno en realidad - well actually - no hint
la noche - the night - no hint
acerca de - about - no hint
lado asiático - asian side - no hint
me pueden dar una manta - may i have a blanket - no hint
sofá - couch - no hint
niño - kid - no hint
diferencia - difference - no hint
libro - book - no hint
necesito - needed - no hint
viejo - old - no hint
alto - high - no hint
húmedo - damp - no hint
esta zona es peligrosa - this area is dangerous - no hint
la tarea del estudiante es hacer la tarea - the student39s homework is to do homework - no hint
debe - has to - no hint
estoy ocupado esta semana - i am busy this week - no hint
entre - come in - no hint
valor - value - no hint
quemaremos si no vuelven - we will burn if they don39t come back - no hint
mia - my - no hint
bajo - under - no hint
extranjero - foreign - no hint
si se han ido - if they have gone - no hint
hoy - today - no hint
fórmula - formula - no hint
pegar - take - no hint
comparación - comparison - no hint
rico - rico - no hint
técnico - technical - no hint
ser - to be - no hint
eficiente - efficient - no hint
comer mañana - eat tomorrow - no hint
es posible venir mañana - it is possible to come tomorrow - no hint
pueblo - town - no hint
nuestras costumbres - our customs - no hint
dejarlo - leave it - no hint
motocicleta - motorcycle - no hint
chaqueta - jacket - no hint
helicóptero - helicopter - no hint
doctor - doctor - no hint
hotel - hotel - no hint
quieres - want - no hint
quemadura - burn - no hint
un - a - no hint
tú - your - no hint
donde estabas cuando huimos - where we're you when we ran away - no hint
atmósfera - atmosphere - no hint
viva - alive - no hint
divertido - funny - no hint
cuando volverá - when will he return - no hint
oír - hear - no hint
uf se escapó de nuevo - ugh he ran away again - no hint
creo que es bueno llorando - i think it39s good crying - no hint
fresco - fresh - no hint
corriendo - in a hurry - no hint
cerca del oceano - looking for the ocean - no hint
permiso - excuse me - no hint
único - unique - no hint
adulto - adult - no hint
por supuesto - of course - no hint
que - that - no hint
denso - dense - no hint
ingresar - enterokay - no hint
explicar - explain - no hint
motivar - to motivate - no hint
asar - asar - no hint
niño - kid - no hint
blusa - shirt - no hint
derecho - right - no hint
derecho - right - no hint
mientras corríamos - while we ran - no hint
a quien le importa - who cares - no hint
percibir - perceive - no hint
mi oportunidad - my opportunity - no hint
imposible - impossible - no hint
sitio - site - no hint
captura - capture - no hint
expresión común - common expression - no hint
lluvia - rain - no hint
lluvioso - rainy - no hint
nuevo - new - no hint
asi que - so - no hint
respuesta - answer - no hint
cama - bed - no hint
suficiente - enough - no hint
talento - talent - no hint
verduras - vegetables - no hint
es la ciudad mas bella del mundo - it is the most beautiful city in the world - no hint
medianoche - midnight - no hint
tedioso - tedious - no hint
tienes razón - you are right - no hint
tienes tanta razón hablar es la mejor manera de aprender - you are so right talking is the best way to learn - no hint
entusiasmado - enthusiastic - no hint
estas durmiendo - are you sleeping - no hint
estoy muy emocionado - i am very excited - no hint
sin - without - no hint
contento - happy - no hint
emocionante - exciting - no hint
a menudo - often - no hint
has terminado - you have finished - no hint
tomó - i take - no hint
estaba tan sorprendido - i was so surprised - no hint
viaje - travel - no hint
como eso - how that - no hint
pedir - ask for - no hint
qué pasa - what39s the matter - no hint
otro - other - no hint
me duele la cabeza - i have a headache - no hint
bebé - baby - no hint
recibir - to receive - no hint
llamar - call - no hint
puede volver a llamarte más tarde - can call you back later - no hint
sabor de - taste of - no hint
edad - age - no hint
feo - ugly - no hint
venir - come - no hint
cumplido - compliment - no hint
avergonzado - ashamed - no hint
sucio - dirty - no hint
merecer - to deserve - no hint
kar - kar - no hint
ver - watch - no hint
adelante - ahead - no hint
dolor - pain - no hint
disfruta siendo disfruta divirtiéndote - enjoy being enjoy having fun - no hint
encontrar - meet - no hint
enchufe - plug - no hint
información - information - no hint
vamos - come on - no hint
quiero solicitar unas vacaciones de una semana en junio - i want to request a one week vacation in june - no hint
término - finished - no hint
semana - week - no hint
que mal tiempo - what a bad weather - no hint
cuidado - watch out - no hint
segundos - seconds - no hint
sentir - to feel - no hint
difícil - hard - no hint
vender - to sell - no hint
pequeño - little - no hint
cosa - thing - no hint
su hija - his daughter - no hint
dejar - let - no hint
camisa - shirt - no hint
mira - sight - no hint
pero de esto - but from this - no hint
decisión - decision - no hint
ummak - ummak - no hint
medio - half - no hint
planificar - to plan - no hint
pongo - i put - no hint
champú - shampoo - no hint
los niños se hacen amigos de inmediato - the children become friends immediately - no hint
repugnante - disgusting - no hint
oscuro - dark - no hint
momento - moment - no hint
momento - moment - no hint
sueño - dream - no hint
insatisfecho - dissatisfied - no hint
decir - tell - no hint
tratar - deal - no hint
tengo - have - no hint
caliente - hot - no hint
tirar a la basura - throw away - no hint
vino - wine - no hint
accidente - accident - no hint
bote - world - no hint
en el show - at the show - no hint
mostrar alrededor - show around - no hint
espectáculo - show - no hint
adjetivo - adjective - no hint
por favor firme aquí - sign here please - no hint
encima - above - no hint
su - it's - no hint
sugerir - suggest - no hint
recibir - to receive - no hint
larga historia - long story - no hint
decir - tell - no hint
amigo - friend - no hint
pensar - to think - no hint
caminar - to walk - no hint
cuando abre - when do you open - no hint
que serie estabas viendo - what series we're you watching - no hint
espalda - back - no hint
trabajar - to work - no hint
ritmo - rhythm - no hint
largo - length - no hint
año - year - no hint
mañana - morning - no hint
tan bueno como tu - as good as you - no hint
muchacha - girl - no hint
ganar - win - no hint
pie - pie - no hint
calendario - calendar - no hint
una parte de mi corazon - a part of my heart - no hint
los mejores deseos - best wishes - no hint
difícil - hard - no hint
