evidence - kanıt - no hint
collision - çarpışma - no hint
insult - hakaret - no hint
windsurfing - rüzgâr sörfü - no hint
sums it up - özetliyor - no hint
garage - garaj - no hint
experiment - deney - no hint
conquer - fethetmek - no hint
climate - iklim - no hint
fairly regularly - oldukça düzenli - no hint
water shortage - su sıkıntısı - no hint
i think parents are the blame - bence suçlu anne baba - no hint
point of view - bakış açısı - no hint
grapefruit - greyfurt - no hint
cosmopolitan - kozmopolitan - no hint
we quickly bonded - çabucak bağlandık - no hint
buy me some time - bana biraz zaman kazandır - no hint
will suffer - acı çekecek - no hint
weapon - silah - no hint
angling - olta balıkçılığı - no hint
state - durum - no hint
frustration - hüsran - no hint
assess - değerlendirmek - no hint
souvenir - hafıza - no hint
urgent - acil - no hint
scholar - akademisyen - no hint
souvenir - hafıza - no hint
outweigh - daha ağır gelmek - no hint
peel - soymak - no hint
raincoat - yağmurluk - no hint
butcher - kasap - no hint
common - yaygın - no hint
immerse - daldırmak - no hint
disabled - engelli - no hint
border - sınır - no hint
attractive - çekici - no hint
postpone - ertelemek - no hint
favourable - elverişli - no hint
local - yerel - no hint
nonetheless - her şeye rağmen - no hint
reluctant - isteksiz - no hint
microwave oven - mikrodalga fırın - no hint
flight attendant - uçuş görevlisi - no hint
complained - şikayet etti - no hint
corporate - kurumsal - no hint
prospect - olasılık - no hint
sales representative - satış temsilcis - no hint
improve my mood - ruh halimi iyileştir - no hint
lend - borç vermek - no hint
