çünkü bulaşık deterjanı almaya giderken telefonumdan arnavutça dersi dinliyorum ve yirmiiki dakikası kaldı - porque de camino a comprar jabón para platos, estoy escuchando una lección de albanés en mi teléfono y le quedan veintidós minutos. - no hint
alışkanlığımı kaybettim - perdí mi hábito - a lish can lick you into keeping habits
zihin açıklığı - claridad mental - a chick licks me and everything is clear
kırılmam - no me romperé - a cruel ill mom will never break
belgesel - documental - a documentary about a bell geese sell
amuda kalkıyorum - haciendo una parada de manos - a mood a... changes when you are in a handstand
dik - dik - a steep dick
bu normalin tersi - esto es lo contrario de lo normal - a ter see is the opposite of a sitter
maceralarla dolu rüyalar görürsün inşallah - espero que tengas sueños llenos de aventuras. - adventuresly full of
şu anda baş aşağıyım - estoy boca abajo ahora mismo - ah sh** i'm upside down
ahşap tahtalar - tablas de madera - ah shop only deals with wood
umarım nereden aldığımı hatırlarım - espero recordar donde lo conseguí. - all dim in the place i got it
ışık anahtarları - interruptores de luz - anna tars larry when she flips the switch
omega üç arıyorum - buscando omega tres - are they here are the here, i'm looking everywhere
her zamankinden daha değişikti - era diferente de lo habitual - at this time more kin live in dens then ever before
balkabağı - calabaza - ball ba.. it.. is not a ball, it's a pumpkin
banyo yapmaya ihtiyacım vardı - necesitaba un baño - banyo.. yap my ahhh... i have to go to the bathroom
bezelye - guisante - bayza ill ya, because she ate peas
bilerek - a propósito - be leary of people who wreck things on purpose
değişikti - fue diferente - because it was different, they each say ick
benim için sıkıntı değil - no es problema para mí - being sick int a problem if you have a good immune system
göz önünde bulundurulduğunda - teniendo en cuenta - bull under old dune duh when it is kept here,
bahane - excusa - but honey... this is my excuse
kedi köpekten korkar - gato le tiene miedo al perro - cat from the dog is afraid
bana bir kaşık getirir misin lütfen - ¿puedes traerme una cuchara por favor? - cause shook didn't work we need a spoon
derinlerine - en lo profundo de - dare in lear in deep into a hole,
not defteri - computadora portátil - deaf terry would always have a notebook
düzelttiklerin için teşekkür ederim - gracias por corregir - denzel washington makes a check every time he corrects someone
dondurucu açık - congelador abierto - don put the freezer under you jew
keskin bir bıçak var mı - tienes un cuchillo afilado - don't kiss skin with something sharp,
