öf - uh - no hint
yüreğimin köşesi - corner of my heart - no hint
endişelenme - do not worry - no hint
masallah - wow - no hint
buldüşmek - to meet - no hint
şehre - to the city - no hint
bile - even - no hint
çabuk - quickly - no hint
koşuya - running - no hint
enstrüman - instrument - no hint
ateş - fire - no hint
ateşte - in the fire - no hint
evde - in the house - no hint
çantamdaydı - it was in my bag - no hint
evrensel - universal - no hint
yabancı - foreign - no hint
misafirler - guests - no hint
gerekiyor - is required - no hint
kim umrunda ki - who cares - no hint
kimi umursuyorsun - who do you care about - no hint
o halde - in that case - no hint
boş zamanlarında ne yapıyorsun - what do you do in your spare time - no hint
bu gerçekten yardımcı bir söz - this is a really helpful phrase - no hint
boş zaman - free time - no hint
son zamanlarda - recently - no hint
on iki çıvarında - around twelve - no hint
bir arada - are together - no hint
normalde de geç mi uyursun - do you normally stay up late - no hint
bu yüzden - that's why - no hint
avrupa yakası - european side - no hint
anadolu yakası - anatolian side asian side of istanbul - no hint
kolay gelsin sana - come easy to you - no hint
bu yanlış mı - is this wrong - no hint
bu doğru mu - is this correct - no hint
ne demek istiyorsun - what do yo mean - no hint
başka - what else - no hint
iyi şanslar - good luck - no hint
doydun mu - are you full - no hint
hatırım için - for my sake - no hint
ne için - for what - no hint
acelem var - im in a hurry - no hint
öyle umuyorum - i hope so - no hint
sakin ol - calm down - no hint
bu arada - by the way - no hint
kaç kere - how many times - no hint
uyuyorsun - you are asleep - no hint
ama genellikle sadece türkçe üzerinde çalışıyorum - but usually i am just working on turkish - no hint
ne tür sporlar yaparsın - what type of sports do you do - no hint
iş nasıldı - how was work - no hint
çok destekleyicisin - you are so supportive - no hint
arkadaşın olduğum için şanslıyım - i am lucky to be your friend - no hint
çekmiştim içimden - i was deep inside - no hint
en sevdiğin komik filmler mi - are funny movies your favorite - no hint
umarım iyi bir gün geçirmişsindir - i hope you have had a good day - no hint
bence öyle - sort of i think so - no hint
ne çalışmalıyız - what should we study - no hint
bana bir soru soracaksın - you will ask me a question - no hint
hayır maalesef her şeyi anlamadım - no unfortunately i didn't understand everything - no hint
sanırım anladım - i think i understood - no hint
bunu demelisin - you should say this - no hint
sözlerin çok dikkate değer - your words are very noteworthy - no hint
kalbim eridi - my heart melted - no hint
yürüyüşün nasıldı - how was your walk - no hint
senden naber - what's up with you - no hint
iyilik sağlık - it's all good - no hint
yok bir yaramazlık - can't complain - no hint
iyidir bunu yapıyorum - it's fine i'm just doing this - no hint
uğraşıp duruyoruz ne olsun - not much been keeping busy - no hint
bugün pek bir şey yapmadık - i haven't done much today - no hint
ama dün gece yaklaşık saat bir geç kalktım - but last night i was up late about one o'clock - no hint
sınav dışında bugün ne yaptın - other than the exam what did you do today - no hint
anladığını umuyorum - i hope you understood me - no hint
bana yardım için teşekkür ederim - thank you for helping me - no hint
sanırım tenis oynayacağım - i think i will play tennis - no hint
sanırım kardeşlerimle tenis oynayacağım - i think i will play tennis with my brothers - no hint
programlayacağım - i will program - no hint
program yapacağım - i will do programming - no hint
bu veya şu hangisi doğru - this or that which is correct - no hint
bu cümle benim için yeni - this phrase is new to me - no hint
beni anlayabildiğine sevindim - im glad you could understand it - no hint
evet bunu demek istedim - yes this is what i wanted to say - no hint
üzgünüm dedim sandım - sorry i thought i said - no hint
tekirova küçük bir kasabadır - tekirova is a small town - no hint
sebze kavurmayı severim - i love roasting vegetables - no hint
inanılmaz bir yeteneğin var - you have an incredible talent - no hint
şaka mı yapıyorsun - are you joking - no hint
kardeşlerim arasında çok yaş farkı var - there are many age differences between my siblings - no hint
ismini doğru söyledim mi - did i say your name correctly - no hint
otuz dört yaşındayım - i am thirty four - no hint
kaç yaşındasınız - how old are you - no hint
eğlenmek için ne yaparsın - what do you do for fun - no hint
bugün ilginç bir şey yaptın mı - did you do anything interesting today - no hint
selamlar - greetings - no hint
iyi bir gün geçirdin mi - have you had a good day - no hint
ne yapıyorsun - what are you doing - no hint
evet bende güzel bir gün geçirdim - yes i too have had a good day - no hint
bugün ne yaptın - what did you do today - no hint
güzel bir gün gibi geliyor - sounds like a nice day - no hint
umarım iyisindir - i hope you are doing well - no hint
ve umarım iyisindir - and i hope you are well - no hint
umarım günün iyi geçiyordur - i hope your day is going well - no hint
burada hala erken - it is still early here - no hint
ben pek yapmadım - i have not done much - no hint
mutfağı temizledim - i cleaned the kitchen - no hint
biraz önce uyandım - i woke up a little bit ago - no hint
az önce kahve yaptım - i just made a coffee - no hint
bugün geç uyudum - i slept in late today - no hint
iyi bisiklet sürdüm - i had a good bike ride - no hint
dünden önceki gün pek uyumadım - i didn't sleep much - no hint
iyi uyudum - i slept well - no hint
günüm şimdiye kadar iyi geçti ama hala erken - my day has been good so far but it is still early - no hint
günün nasıldı eğlenceli bir şey yaptın mı - how was your day did you do anything fun - no hint
queens gambit görmedim - i haven't seen queens gambit - no hint
surely watch the queens gambit - the queens gambit mutlaka izle - no hint
bu bir dizi - it is a series - no hint
sadece ilk bölümü izledim - i have only watched the first episode - no hint
ama bir sonrakini izleyeceğim için heyecanlıyım - but i am excited to watch the next - no hint
instagram gönderilerimin çoğunu beğendin - you liked so many of my instagram posts - no hint
o festival çok havalı görünüyor - that festival looks very cool - no hint
jonglörlük festivali ile aynı zaman - it is the exact same time as the juggling festival - no hint
geçenlerde a izledim bende iyi olduğunu düşündüm - i just watched a recently i thought it was good too - no hint
kardeşin var mı - do you have siblings - no hint
sen en yaşlı mısın - are you the oldest - no hint
ben ikinci çocuğum - i am the second child - no hint
evli misin - are you married - no hint
kızın kaç yaşında - how old is your daughter - no hint
çok tatlı bu harika bir yaş - very sweet that is a great age - no hint
üç yaşında bir yeğenim var - i have a niece who is three - no hint
sorumluluğum yok ama çok eğleniyorum - i have no responsibilities but lots of fun - no hint
evcil hayvanım yok - i have no pets - no hint
ama erkek kardeşimin bir kedisi var - but my brother has a cat - no hint
koşuya gittim - i went for a run - no hint
kahve aldım - i got coffee - no hint
verimli bir sabah geçirdim - i have had a productive morning - no hint
evet ingilizce'de circus - yes in english it is circus - no hint
neden türkçe öğrenmek istiyorsuniz - why do you want to learn turkish - no hint
siz bana ingilizce öğreten ben de size türkçe - you teach me english and i'll teach you turkish - no hint
türkçeme iltifat ettiğin için teşekkür ederim - thank you for complimenting my turkish - no hint
ingilizcenden çok etkilendim - i am very impressed with your english - no hint
bir gün senin kadar iyi konuşmayı umuyorum - i hope to speak as good as you someday - no hint
şimdi çeviri çok kullanıyorum - now i use translator a lot - no hint
türkçe yaz - write turkish - no hint
daha fazla konuşma pratiğine ihtiyacım var - i need to practice speaking more - no hint
benim telaffuzum doğru mu - is my pronunciation correct - no hint
yeter be her şey yanlış - enough everything is wrong - no hint
daha doğal - more natural - no hint
bu ve şu arasındaki fark ne - what is the difference between this and that - no hint
bunu cümle içinde kullanabilir misin - can you use this in a sentence - no hint
güzel bir dil - it is a beautiful language - no hint
rusçayı nasıl öğrendin - how did you learn russian - no hint
ne zamandır helllo tallkk kullanıyorsun - how long have you been using helllo tallkk - no hint
kağıda zamirleri yazdım - i wrote pronouns on paper - no hint
bazen imkansız görünüyor - sometimes it seems impossible - no hint
tek başıma cümle kurmalıyım - i need to make a sentence on my own - no hint
çok çeviri kullanıyorum - i use translate a lot - no hint
çok güzel bir aksanın var - you have a very nice accent - no hint
tavsiyen için teşekkürler - thank you for your advice - no hint
türkçe konusunda yardıma ihtiyacım var - i need help with turkish - no hint
beni anlıyor musun - can you understand me - no hint
okumaya çalışıyorum zor - i am trying to read it is difficult - no hint
türkçe konuşmamı sevmene çok sevindim bana motivasyon veriyor - im very happy that you like when i speak turkish it gives me motivation - no hint
ne dediğimi anlıyor musun - could you understand what i said - no hint
türkiyenin neresindensin - where in turkey are you from - no hint
türkiye'nin neresinde yaşıyorsun - what part of turkey do you live in - no hint
hangi şehirdensin - which city are you from - no hint
azerbaycan türküyüm - i am azerbaijani turkish - no hint
orada mı doğdun - were you born there - no hint
ne zaman ayrıldın - when did you leave - no hint
aksanını seviyorum - i love your accent - no hint
şu anda burada çok kar yağıyor - it is snowing a lot here right now - no hint
olduğun yerde hiç kar yağar mı - do you ever get snow where you are - no hint
burada kar yağması çok sıradışı - it is very unusual for it to snow here - no hint
oraya yaklaşık dört yıl önce gittim - i went there about four years ago - no hint
hayır hiç etmedim - no i never did - no hint
orayı ziyaret ettin mi - have you visited there - no hint
yurtdışına çıktın mı - have you ever left turkey - no hint
hayır hiç gitmedim - no i've never gone - no hint
ben seni gezdiririm - i'll show you around - no hint
hayır maalesef çıkamadım - no unfortunetly i haven't left - no hint
param yok çünkü - because i don't have money - no hint
geçen yil üç ay türkiyede yaşadım - last year i lived in turkey for three months - no hint
işin çok seyahat etmene izin veriyor mu - does your job allow you to travel much - no hint
bazı güzel yerlere gittin - you have been to some nice places - no hint
usa'de nereyi ziyaret etmek istersin - where in the us do you want to visit - no hint
bu yaz gelmek istiyorum - i want to come this summer - no hint
pandemiye bağlıdır - it depends on the pandemic - no hint
tüm hayatım seyahat ediyor - my whole life is travelling - no hint
ama çok seyahat ederim - but i travel a lot - no hint
kadıköy yakınlarında kaldım - i stayed near kadıköy - no hint
hiç yurtdışına çıktın mı - have you ever traveled abroad - no hint
ama belki türkiye'de daha yaygındır - but maybe in turkey it is more common - no hint
arkadaşlarımın istanbulda sirk merkezi var - my friends have a circus center in istanbul - no hint
orada sirk dersleri veriyorlar - they teach circus classes there - no hint
öğrenci misiniz - are you a student - no hint
ne okuyorsun - what do you study - no hint
kimya okuyorum - i study chemistry - no hint
sınavında nasıl geçtiğini öğrendin mi - did you find out how you did on your exam - no hint
bugün okulun var mıydı - did you have school today - no hint
daha kaç yılın var - how many more years do you have - no hint
kaç yıldır üniversitede okuyorsun - how many years have you been in university - no hint
sınavın nasıl gitti - how did your exam go - no hint
umarım iyi gitmiştir - i hope it went well - no hint
bu bir okul toplantısı mı - is it a school meeting - no hint
gerçek bir sınıfa geri dönebildiğin zaman çok güzel olacak - it will be so nice when you can be back in a real classroom - no hint
öğrencilerin kaç yaşında - what age are your students - no hint
ne öğretiyorsun - what do you teach - no hint
ne zamandır öğrettin - how long have you taught - no hint
ben bir öğretmendim - i was a teacher - no hint
kaç öğrenciniz vardı - how many students did you have - no hint
çalışıyor musunuz - do you work - no hint
ben bir hokkabazım - i am a juggler - no hint
ben bir sirk sanatçısıyım - i am a circus performer - no hint
ama birçok işim oldu - but i have had many jobs - no hint
yaz üniversite bittiğinde ne yapacaksın - what will you do in the summer when university is done - no hint
evet bu çok eğlenceli bir iş ne iş yapıyorsun - yes it is a very fun job what is your job - no hint
iç mimarlık - interior design - no hint
ne iş yapıyorsun - what is your job - no hint
ne zamandır oyuncu olmak istedin - how long have you wanted to be an actress - no hint
bilimi gerçekten iyi bilmen harika - o cool you must know science really well - no hint
oyunculuğun iyi olduğunu düşünüyorum - i think the acting is good - no hint
kaba olan kız sanırım adı sezon - the girl who was mean i think her name is season - no hint
arkadaş olmak istiyorum - i want to be friends - no hint
komiksin beni güldürüyorsun - you're funny you make me laugh - no hint
oh benim çok komiksin - oh my you're so funny - no hint
bende seninle oynamayı çok isterim - i would love to play with you too - no hint
çok zarifsin - you are so elegant - no hint
bunu söylediğin için minnettarım - i appreciate you saying this - no hint
teşekkür ederim tatlısın - thank you you are sweet - no hint
çok teşekkür ederim çok naziksin - thank you very much you are very kind - no hint
ama çok tuhaf bir başkan oldu - but he was a strange president - no hint
koşuta çıkıyorum - i'm going for a run - no hint
sana iyi uykular - sleep well - no hint
gitmek zorundayım - i have to go - no hint
seninle konuşmak çok güzeldi - it was very nice talking to you - no hint
gecenin geri kalanının tadını çıkar - enjoy the rest of your night - no hint
ve yakında seninle konuşmayı umuyorum - and i hope to talk to you soon - no hint
umarım yakında tekrar konuşabiliriz - hopefully we can talk again soon - no hint
kesinlikle şu anda uyuyorsun - certainly you are asleep right now - no hint
bir hayalim vardı - i had one dream - no hint
sık sık rüya görür müsün - do you dream often - no hint
umarım şu anda hayallerinde maceralar yaşıyorsundur - i hope you are having adventures in your dreams right now - no hint
keske olsa - if only - no hint
insan her gün yeni bir şeyler öğreniyor zaten - every day one learns something new - no hint
bir sorum var - i have a question - no hint
o beni gayette seviyor - well obviously he loves me - no hint
sen uyumuyor musun çok geç - don't you sleep it is so late - no hint
boşver şimdi biliyorum - nevermind i know now - no hint
gün henüz yeni başladı - the day has just begun - no hint
bu zor geliyor - that sounds tough - no hint
isim üstte - the name is at the top - no hint
ikisini de beğendim - i liked both of those - no hint
dünden önceki gün - the day before yesterday - no hint
buradaki her şey mükemmel - everything here is perfect - no hint
seni instagramda buldum - i found you in instagram - no hint
ne demek istiyorsun - what do you mean - no hint
ve sana yardım edebilirim - and i can help you - no hint
ama uzun sürmez - but not for long - no hint
hiç bunu görmedim - i have never seen this - no hint
özür dileyecek hiçbir şey yok - there is nothing at all to apologize for - no hint
zor sorular iyi sorulardır - hard questions are good questions - no hint
evet bu harika olur - yes that would be great - no hint
ilki en iyisidir - is the first one the best - no hint
yani belki iyidir - so maybe it is good - no hint
ama o olduğunu düşünüyorum - but i think it is - no hint
hala beklemek için bir buçuk saatim var - i still have an hour and a half to wait - no hint
kendi kendime konuşuyordum - i was talking to myself - no hint
peki onun yerine ne yapıyorsun - so what do you do instead - no hint
bu ile şu arasındaki fark nedir - what is the difference between this and that - no hint
senle konuşacağım - i will speak with you - no hint
diğer arkadaşlarımla konuşacağım - i will speak with other friends - no hint
attım mesaj - i sent a message - no hint
bu tam cümle - this is the full sentence - no hint
fotoğraf çekmek - take photos - no hint
kişisel algıladım - ı took it personally - no hint
içimden bir şarkı yazmak gelmişti - i felt like writing a song - no hint
bu yaygın bir ifade mi - is that a common expression - no hint
programlamayı severim - i like to program - no hint
dün sabah çekmiştim - i took it yesterday morning film - no hint
şahsen konuşmak benim için zor - it is hard for me to speak in person - no hint
göndermeden önce - before sending - no hint
normalde bir mesaj göndermeden önce çeviri yapabilir ve pratik yapabilirim - normally i can translate and practice before i send a message - no hint
şimdi kullanabileceğim bazı sözlerim var - i have some phrases i can use now - no hint
türkçe pratik yaptım - i practiced turkish - no hint
şu anda sadece türkçe pratik yapıyorum - right now just practicing turkish - no hint
yapalım şunu - let's do it - no hint
buraya bakalım - let's see here - no hint
ne yapıyorum - what am i doing - no hint
ama bu sabah erken saatlerde - but earlier this morning - no hint
yürüyüşe çıktım - i went for a walk - no hint
hokkabazlık yaptım - i juggled - no hint
arabayı temizledim - i cleaned the car - no hint
biraz su içtim - i drank some water - no hint
bence hepsi bu - i think that is all - no hint
kardeşimi bir yere sürdüm şimdi onu bekliyorum - i drove my brother somewhere now i am waiting for him - no hint
geçenlerde koşuya gittim - i recently went for a run - no hint
şimdiye kadar - until now - no hint
öyleyse sür ve koş bugün şimdiye kadar yaptığım tek şey - so drive and run is all i have done so far today - no hint
bugün dışarı çıktın mı - did you go out today - no hint
belki pazara veya bir parka mı - maybe to the market or to a park - no hint
dersin iyi gitti mi - did your lesson go well - no hint
sonuçları zaten aldın mı - do you already have the results - no hint
sihirbaz - wizard - no hint
gerçek - real - no hint
sınıfa - to class - no hint
geri - back - no hint
dönebildiğin - you can return - no hint
toplantı - meeting - no hint
geçenlerde - recently - no hint
olduğunu - that it is - no hint
sürmez - does not last - no hint
özür dilemek - to apologize - no hint
sorular - questions - no hint
bence - i think - no hint
oynatmak - to play - no hint
zarif - elegant - no hint
olur - would be fine - no hint
lise - high school - no hint
kolej - college - no hint
yani - so - no hint
kendi - own self - no hint
yerine - instead - no hint
fark - difference - no hint
nedir - what - no hint
eğlenceli - enjoyable - no hint
bilim - science - no hint
oyunculuğun - your acting - no hint
sanmak - to think implies wrong assumption - no hint
düşünmek - to think cognitive action - no hint
bence - in my opinion - no hint
yaygın - common - no hint
stresliyim - i am stressed - no hint
mesaj - message - no hint
ifade - expression - no hint
tam - full - no hint
çekmek - take photos - no hint
kişisel - personal - no hint
içimden - inside of me - no hint
şarkı - song - no hint
kullanabileceğim - i will be able to use - no hint
yapalım - let's do - no hint
saatlerde - in the hours - no hint
hepsi - all adverbnoun - no hint
şimdiye - to now - no hint
dışarı - out - no hint
sonuç - result - no hint
doymak - to be full - no hint
kere - times - no hint
müsait - available - no hint
üzerine - over - no hint
desteklemek - to support - no hint
çekmek - attract - no hint
sanırmak - to think - no hint
demelisin - you should say - no hint
dikkate - consideration - no hint
uyanık - awake - no hint
ayrıca - also - no hint
kulak - ear - no hint
kalp - heart - no hint
nolsun - not much - no hint
iyilik - it's fine - no hint
iyilik - favor - no hint
sağlık - health - no hint
yaramazlık - mischief - no hint
durmak - to stand stop - no hint
beğendim - i like it - no hint
üzgünüm - i'm sorry - no hint
farkı - difference - no hint
klinik - clinic - no hint
klasik - classical - no hint
efor - effort - no hint
enformasyon - information - no hint
islâm - islam - no hint
kantin - canteen - no hint
kanal - channel - no hint
komedi - comedy - no hint
kriz - crisis - no hint
ekstrem - extreme - no hint
ideoloji - ideology - no hint
ideolojik - ideological - no hint
ceket - jacket - no hint
kuran - koran - no hint
laboratuvar - lab - no hint
lazer - recreation - no hint
lider - leader - no hint
melodi - melody - no hint
milimetre - millimeter - no hint
orijinal - original - no hint
kampanya - campaign - no hint
kanser - cancer - no hint
şampiyon - champion - no hint
karakter - character - no hint
koro - koro - no hint
kompleks - kompleks - no hint
kompozisyon - composition - no hint
kontrol - control - no hint
krem - cream - no hint
krema - cream - no hint
kredi kartı - credit card - no hint
dans - dance - no hint
derece - degree - no hint
dedektif - detective - no hint
ekonomi - the economy - no hint
ekonomik - economic - no hint
enerjik - energetic - no hint
egzotik - exotic - no hint
ekstra - additional - no hint
favori - favorite - no hint
federal - federal - no hint
film - film - no hint
final - final - no hint
gri - gray - no hint
garantili - guaranteed - no hint
harmoni - harmony - no hint
helikopter - helicopter - no hint
hobi - hobby - no hint
endüstriyel - industrial - no hint
enflasyon - inflation - no hint
ironik - ironic - no hint
jüri - jüri - no hint
lamba - lamba - no hint
liberal - liberal - no hint
magazin - magazin - no hint
menajer - manager - no hint
maç - match - no hint
to leave a message - to leave a message - no hint
menü - menu - no hint
metafor - metaphor - no hint
metropol - metropolis - no hint
metre - meter - no hint
momentum - momentum - no hint
organik - organic - no hint
to organize - to organize - no hint
organizasyon - organization - no hint
to park vehicle - to park vehicle - no hint
oksijen - oxygen - no hint
paket - package - no hint
söylediği - he said - no hint
buton - button - no hint
kamp - match - no hint
karbonhidrat - carbohydrate - no hint
karbon - carbon - no hint
kart - map - no hint
kariyer - career - no hint
katalog - katalog - no hint
katolik - catholic - no hint
yumuşak - soft - no hint
çikolata - chocolate - no hint
sinema - cinema - no hint
sivil - civilian - no hint
kahve - coffee - no hint
kolektif - collective - no hint
koloni - colony - no hint
komedyen - comedian - no hint
komünikasyon - communication - no hint
konsantrasyon - concentration - no hint
kopya - copy - no hint
koridor - corridor - no hint
kredi - credit - no hint
kriter - criterion - no hint
kültürel - cultural - no hint
detay - detail - no hint
diplomat - diplomat - no hint
diploma - diploma - no hint
direkt - directly - no hint
doküman - document - no hint
ansiklopedi - encyclopedia - no hint
garaj - garage - no hint
jenerasyon - generation - no hint
jest - is - no hint
garanti - warranty - no hint
hamburger - hamburger - no hint
onur - honor - no hint
otel - hotel - no hint
illegal - illegal - no hint
illüzyon - illusion - no hint
indeks - index - no hint
entegrasyon - integration - no hint
enternasyonal - international - no hint
enstitü - institute - no hint
ironi - irony - no hint
jet - jet - no hint
lig - league - no hint
limonata - lemonade - no hint
limit - limit - no hint
to list - to list - no hint
lobi - lobby - no hint
to massage - to massage - no hint
lokal - local - no hint
madalya - medal - no hint
mesaj - message - no hint
milyon - million - no hint
to become a millionaire - to become a millionaire - no hint
milyoner - millionaire - no hint
mental - mental - no hint
molekül - molecule - no hint
müslüman - muslim - no hint
objektif - objective - no hint
organ - organ - no hint
panel - panel - no hint
park - park - no hint
pasta - cake - no hint
penaltı - penalty - no hint
personel - staff - no hint
kablo - cable - no hint
kakao - cocoa - no hint
kamera - camera - no hint
kampüs - campus - no hint
kapasite - capacity - no hint
kaptan - captain - no hint
karavan - caravan - no hint
karnaval - carnival - no hint
kategori - category - no hint
kaos - tshirt - no hint
kimya - chemistry - no hint
hıristiyan - christian - no hint
sigara - cigaret - no hint
kulüp - club - no hint
kola - kola - no hint
komik - funny - no hint
komite - committee - no hint
komplike - complicated - no hint
konsept - the concept - no hint
kuzen - cousin - no hint
kritik - criticism - no hint
demokrasi - democracy - no hint
demokratik - democratic - no hint
depresyon - depression - no hint
dizayn - design - no hint
diyalog - dialogue - no hint
dijital - digital - no hint
dezavantaj - disadvantage - no hint
disiplin - discipline - no hint
drama - drama - no hint
doktor - doctor - no hint
empati - empathy - no hint
enerji - energy - no hint
ekipman - equipment - no hint
eksper - expert - no hint
federasyon - federation - no hint
finans - finance - no hint
finansal - financial - no hint
format - format - no hint
forum - forum - no hint
ful - ful - no hint
fonksiyon - function - no hint
galeri - gallery - no hint
gaz - gas - no hint
jandarma - gendarme - no hint
centilmen - gentleman - no hint
geometri - geometry - no hint
gol - goal - no hint
golf - golf - no hint
gramer - grammar - no hint
grup - group - no hint
gitar - guitar - no hint
jimnastik - gymnastics - no hint
habitat - habitat - no hint
hol - where - no hint
hokey - hockey - no hint
hipotez - hypotheses - no hint
ideal - ideal - no hint
illüzyonist - illusionist - no hint
imaj - image - no hint
internet - internet - no hint
şiş kebap - shish kebab - no hint
kilometre - kilometer - no hint
limon - lemon - no hint
lira - lira - no hint
litre - liter - no hint
to mask - to mask - no hint
makine - machine - no hint
manüel - manual - no hint
mart - march - no hint
maske - mask - no hint
materyal - materiel - no hint
matematik - maths - no hint
mayıs - may - no hint
mekanizma - mechanism - no hint
mesaj göndermek - to send a message - no hint
to pass on a message - to pass on a message - no hint
metaforik - metaphor - no hint
metot - method - no hint
mobil - car - no hint
müzik - music - no hint
müzikal - musical - no hint
mit - with - no hint
negatif - negative - no hint
normal - normal - no hint
nota - note - no hint
numara - number - no hint
ofis - office - no hint
olimpiyat oyunları - olympic games - no hint
opera - opera - no hint
operasyon - operation - no hint
to photocopy - to photocopy - no hint
panik - panic - no hint
partner - partner - no hint
parti - set off - no hint
biber - pepper - no hint
performans - performance - no hint
perspektif - perspective - no hint
fobi - phobia - no hint
fonetik - phonetics - no hint
bot - bot - no hint
badigard - badigard - no hint
bomba - bomb - no hint
kafe - kafe - no hint
santimetre - centimeter - no hint
koleksiyon - collection - no hint
konser - concert - no hint
konferans - conference - no hint
kontrat - contract - no hint
kostüm - costume - no hint
kültür - culture - no hint
diplomatik - diplomatic - no hint
disk - disk - no hint
dolar - dollar - no hint
editör - editor - no hint
elektronik - electronic - no hint
etik - ethic - no hint
etnik - ethnic - no hint
avro - euro - no hint
egzersiz - exercise - no hint
faktör - factor - no hint
finiş - finish - no hint
galaksi - galaxy - no hint
general - general - no hint
genel - general - no hint
coğrafya - geography - no hint
geometrik - geometric - no hint
global - global - no hint
alo - alo - no hint
idealist - idealist - no hint
endirekt - endirekt - no hint
enfeksiyon - infection - no hint
enstrüman - instrument - no hint
kilogram - kilogram - no hint
legal - legal - no hint
lisans - license - no hint
to lobby - to lobby - no hint
market - market - no hint
masaj - massage - no hint
maksimum - maximum - no hint
mekanik - mechanical - no hint
mineral - mineral - no hint
minimum - minimum - no hint
minibüs - minibus - no hint
mini etek - mini skirt - no hint
minibar - minibar - no hint
model - model - no hint
modern - modern - no hint
moral - moral - no hint
motor - motor - no hint
müze - museum - no hint
natürel - natural - no hint
not - not - no hint
olimpik - olympic - no hint
to panic - to panic - no hint
organize - organize - no hint
periyot - period - no hint
adres - address - no hint
asistan - attend - no hint
branş - branch - no hint
seremoni - ceremony - no hint
kristal - crystal - no hint
fakülte - faculty - no hint
futbol - football - no hint
form - form - no hint
fonksiyonel - functional - no hint
gram - gram - no hint
medya - media - no hint
metal metalik - metallic metallic - no hint
motivasyon - motivation - no hint
nükleer - nuclear - no hint
operatör - operator - no hint
sprey - spray - no hint
teleskop - telescope - no hint
terör - terror - no hint
terörist - terrorist - no hint
otomatik - automatic - no hint
bisküvi - biscuit - no hint
patates - potato - no hint
prens - prince - no hint
promosyon - promotion - no hint
protein - protein - no hint
risk - risk - no hint
rutin - routine - no hint
salata - salad - no hint
opposite sex - opposite sex - no hint
sempatik - sympathetic - no hint
teknik - technical - no hint
teknoloji - technology - no hint
to telegraph - to telegraph - no hint
terörizm - terrorism - no hint
arena - arena - no hint
atlet - athlete - no hint
oto - auto - no hint
otobiyografi - autobiography - no hint
versiyon - version - no hint
balkon - balcony - no hint
biyoloji - biology - no hint
büro - office - no hint
pozisyon - position - no hint
profil - profile - no hint
protesto - protest - no hint
radikal - radical - no hint
rasyonel - rational - no hint
sandviç - sandwich - no hint
spor - sport - no hint
stadyum - stadium - no hint
standart - standard - no hint
şaşırmak - be surprised - no hint
stratejik - strategic - no hint
süpermarket - supermarket - no hint
sempati - sympathy - no hint
taktik - tactics - no hint
taksi - taxi - no hint
telgraf - telegram - no hint
to telephone - to telephone - no hint
televizyon - television - no hint
tropik - tropics - no hint
tünel - tunnel - no hint
atletik - athletics - no hint
apartman - apartment - no hint
ağustos - august - no hint
üniversite - university - no hint
video - video - no hint
otomobil - car - no hint
vizyon - vision - no hint
balon - balloon - no hint
banka - bank - no hint
basketbol - basketball - no hint
blucin kot - blucin kot - no hint
bravo - bravo - no hint
fotokopi - photocopy - no hint
fotoğraf - photo - no hint
to picnic - to picnic - no hint
pizza - pizza - no hint
plan - plan - no hint
politik - political - no hint
portre - portrait - no hint
popüler - popular - no hint
potansiyel - potential - no hint
paunt - paune - no hint
profesör - professor - no hint
prosedür - procedure - no hint
protokol - protokol - no hint
psikoloji - psychology - no hint
risky - risky - no hint
psikolog - psychologist - no hint
realist - realist - no hint
realite - reality - no hint
rejim - diet - no hint
restoran - restaurant - no hint
robot - robot - no hint
roket - rocket - no hint
rol - role - no hint
romantik - romantic - no hint
senaryo - scenario - no hint
selfie - selfie - no hint
seminer - seminar - no hint
şampuan - shampoo - no hint
sosyal - social - no hint
istasyon - station - no hint
şaşırtmak - surprise - no hint
statü - status - no hint
strateji - strategy - no hint
stres - stress - no hint
sübjektif - subjective - no hint
sürpriz - surprise - no hint
sembol - symbol - no hint
sembolik - symbolic - no hint
sistem - system - no hint
tablet - tablet - no hint
tank - tank - no hint
teknolojik - technological - no hint
telefon - telephone - no hint
tenis - tennis - no hint
test - test - no hint
aktif - active - no hint
anti - anti - no hint
tropikal - tropical - no hint
üniforma - uniform - no hint
ünite - unit - no hint
vazo - vase - no hint
virüs - virus - no hint
bakteri - bacteria - no hint
vizyoner - visionary - no hint
vitamin - vitamin - no hint
bar - bar - no hint
bariyer - barrier - no hint
biyolojik - biological - no hint
to photograph - to photograph - no hint
fizik - physics - no hint
piyano - piano - no hint
police officer - police officer - no hint
pilot - pilot - no hint
polis - police - no hint
poliçe - policy - no hint
politika - politics - no hint
pozitif - positive - no hint
pratik - practical - no hint
pratik n - pratik n - no hint
prezantasyon - presentation - no hint
profesyonel - professional - no hint
program - program - no hint
proje - project - no hint
reform - reform - no hint
rapor - report - no hint
romantizm - romance - no hint
sos - you are - no hint
skandal - scandal - no hint
sektör - sector - no hint
seküler - secular - no hint
servis - service - no hint
şov - show - no hint
spekülasyon - speculation - no hint
star - star - no hint
stüdyo - studio - no hint
şeker - candy - no hint
süper - super - no hint
akademi - academy - no hint
asit - acid - no hint
aktris - actress - no hint
avantaj - advantage - no hint
trajedi - tragedy - no hint
antidemokratik - antidemocratic - no hint
aritmetik - arithmetic - no hint
tüp - tube - no hint
alfabe - alphabet - no hint
üniversal - universal - no hint
volüm - volume - no hint
yat - yacht - no hint
bisiklet - bike - no hint
piknik - picnic - no hint
poster - poster - no hint
prenses - princess - no hint
prensip - principle - no hint
problem - problem - no hint
to protest - to protest - no hint
radyo - radio - no hint
reaksiyon - reaction - no hint
rol model - role model - no hint
skor - score - no hint
sekreter - secretary - no hint
seks - sex - no hint
seksi - sexy - no hint
spesifik - specific - no hint
to have sex - to have sex - no hint
teolojik - theological - no hint
termometre - thermometers - no hint
tuvalet - toilet - no hint
alternatif - alternative - no hint
amatör - amateur - no hint
trafik - traffic - no hint
tren - train - no hint
antipati - antipathy - no hint
antipatik - distasteful - no hint
astronot - astronaut - no hint
voleybol - volleyball - no hint
bagaj - luggage - no hint
büyük - big - no hint
plastik - plastic - no hint
sponsor - sponsor - no hint
aksan - accent - no hint
aksiyon - action - no hint
terapist - therapist - no hint
teori - theory - no hint
alkol - alcohol - no hint
alkolik - alcoholic - no hint
tür - there - no hint
turizm - tourism - no hint
analiz - analiz - no hint
trajik - tragic - no hint
akademik - academic - no hint
tip - tip - no hint
tiyatro - theater - no hint
terapi - therapy - no hint
teoloji - theology - no hint
aktör - actor - no hint
adaptasyon - adaptation - no hint
teorik - theoric - no hint
alarm - alarm - no hint
albüm - album - no hint
domates - tomato - no hint
ton - your - no hint
ambulans - ambulance - no hint
tişört - tshirt - no hint
tv - tv - no hint
iyi - good - no hint
tekst - text - no hint
turist - tourist - no hint
turnuva - tournament - no hint
transfer - transfer - no hint
tolerans - tolerance - no hint
bilmek - know - no hint
yapamaz - no hint - no hint
hapı yutmak - be in trouble - no hint
ellerine sağlık - god bless your hands - no hint
sonra anlatırım uzun hikaye - i'll tell you later it's a long story - no hint
çok temiz kalplisin - you are pure hearted - no hint
iyi geceler allah rahatlık versin - good night sleep tight - no hint
kafaya koymak - set your mind to something - no hint
senin için hayırlısı olsun - hope the best for you - no hint
ne güzel bir bebek nazar değmesin - what a beautiful baby touch wood - no hint
can kulağı ile dinlemek - be all ears - no hint
içim içime sığmıyor - i'm very excited happy - no hint
temiz kalpli - pure hearted person - no hint
yok daha neler - give me a break - no hint
göz gezdirmek - look over - no hint
öf1 - uh - no hint
masallah1 - wow - no hint
şehre1 - to the city - no hint
bile1 - even - no hint
ateş1 - fire - no hint
ateş2 - fire - no hint
ateş3 - fire - no hint
yabancı1 - foreign - no hint
boş zaman1 - free time - no hint
başka1 - what else - no hint
başka2 - what else - no hint
başka3 - what else - no hint
iyi şanslar1 - good luck - no hint
iyi şanslar2 - good luck - no hint
ne yapıyorsun1 - what are you doing - no hint
fotoğraf çekmek1 - take photos - no hint
olduğunu1 - that it is - no hint
olur1 - would be fine - no hint
kolej1 - college - no hint
yani1 - so - no hint
yani2 - so - no hint
yani3 - so - no hint
kendi1 - own self - no hint
kendi2 - own self - no hint
kendi3 - own self - no hint
kendi4 - own self - no hint
kendi5 - own self - no hint
bilim2 - science - no hint
mesaj1 - message - no hint
şarkı1 - song - no hint
şarkı2 - song - no hint
şarkı3 - song - no hint
ayrıca1 - also - no hint
kulak1 - ear - no hint
kulak2 - ear - no hint
kulak3 - ear - no hint
kalp1 - heart - no hint
kalp2 - heart - no hint
sağlık1 - health - no hint
sağlık2 - health - no hint
klasik1 - classical - no hint
islâm1 - islam - no hint
islâm2 - islam - no hint
islâm3 - islam - no hint
komedi1 - comedy - no hint
ceket1 - jacket - no hint
laboratuvar1 - lab - no hint
lazer1 - recreation - no hint
kompleks1 - kompleks - no hint
kompozisyon1 - composition - no hint
dedektif1 - detective - no hint
ekonomi1 - the economy - no hint
ekonomik1 - economic - no hint
film1 - film - no hint
film2 - film - no hint
film3 - film - no hint
gri1 - gray - no hint
gri2 - gray - no hint
helikopter1 - helicopter - no hint
enflasyon1 - inflation - no hint
lamba1 - lamba - no hint
lamba2 - lamba - no hint
organizasyon1 - organization - no hint
oksijen1 - oxygen - no hint
sinema1 - cinema - no hint
sinema2 - cinema - no hint
kahve1 - coffee - no hint
kahve2 - coffee - no hint
kahve3 - coffee - no hint
kahve4 - coffee - no hint
kahve5 - coffee - no hint
kahve6 - coffee - no hint
kahve7 - coffee - no hint
garaj1 - garage - no hint
jenerasyon1 - generation - no hint
hamburger1 - hamburger - no hint
onur1 - honor - no hint
onur2 - honor - no hint
onur3 - honor - no hint
onur4 - honor - no hint
onur5 - honor - no hint
otel1 - hotel - no hint
otel2 - hotel - no hint
limonata1 - lemonade - no hint
limonata2 - lemonade - no hint
milyon1 - million - no hint
milyon2 - million - no hint
objektif1 - objective - no hint
pasta1 - cake - no hint
pasta2 - cake - no hint
pasta3 - cake - no hint
pasta4 - cake - no hint
pasta5 - cake - no hint
kaptan1 - captain - no hint
kategori1 - category - no hint
kaos1 - tshirt - no hint
kimya1 - chemistry - no hint
sigara1 - cigaret - no hint
sigara2 - cigaret - no hint
sigara3 - cigaret - no hint
kola1 - kola - no hint
kola2 - kola - no hint
kola3 - kola - no hint
komik1 - funny - no hint
doktor1 - doctor - no hint
doktor2 - doctor - no hint
doktor3 - doctor - no hint
doktor4 - doctor - no hint
doktor5 - doctor - no hint
ekipman1 - equipment - no hint
gol1 - goal - no hint
gol2 - goal - no hint
gol3 - goal - no hint
grup1 - group - no hint
gitar1 - guitar - no hint
gitar2 - guitar - no hint
illüzyonist1 - illusionist - no hint
internet1 - internet - no hint
limon1 - lemon - no hint
limon2 - lemon - no hint
limon3 - lemon - no hint
makine1 - machine - no hint
makine2 - machine - no hint
mart1 - march - no hint
metot1 - method - no hint
müzik1 - music - no hint
müzik2 - music - no hint
negatif1 - negative - no hint
negatif2 - negative - no hint
normal1 - normal - no hint
biber1 - pepper - no hint
performans1 - performance - no hint
perspektif1 - perspective - no hint
kafe1 - kafe - no hint
santimetre1 - centimeter - no hint
dolar1 - dollar - no hint
dolar2 - dollar - no hint
editör1 - editor - no hint
avro1 - euro - no hint
galaksi1 - galaxy - no hint
galaksi2 - galaxy - no hint
coğrafya1 - geography - no hint
alo1 - alo - no hint
müze1 - museum - no hint
not1 - not - no hint
adres1 - address - no hint
asistan2 - attend - no hint
asistan3 - attend - no hint
fakülte1 - faculty - no hint
futbol1 - football - no hint
futbol2 - football - no hint
futbol3 - football - no hint
nükleer1 - nuclear - no hint
teleskop1 - telescope - no hint
terörist1 - terrorist - no hint
bisküvi1 - biscuit - no hint
patates1 - potato - no hint
patates2 - potato - no hint
salata1 - salad - no hint
terörizm1 - terrorism - no hint
arena1 - arena - no hint
atlet1 - athlete - no hint
versiyon1 - version - no hint
biyoloji1 - biology - no hint
biyoloji2 - biology - no hint
büro1 - office - no hint
büro2 - office - no hint
sandviç1 - sandwich - no hint
spor1 - sport - no hint
spor2 - sport - no hint
stadyum1 - stadium - no hint
televizyon1 - television - no hint
televizyon2 - television - no hint
televizyon3 - television - no hint
atletik1 - athletics - no hint
apartman1 - apartment - no hint
ağustos1 - august - no hint
üniversite1 - university - no hint
üniversite2 - university - no hint
üniversite3 - university - no hint
üniversite4 - university - no hint
üniversite5 - university - no hint
üniversite6 - university - no hint
üniversite7 - university - no hint
üniversite8 - university - no hint
otomobil1 - car - no hint
otomobil2 - car - no hint
balon1 - balloon - no hint
banka1 - bank - no hint
banka2 - bank - no hint
banka3 - bank - no hint
basketbol1 - basketball - no hint
basketbol2 - basketball - no hint
fotoğraf1 - photo - no hint
fotoğraf2 - photo - no hint
pizza1 - pizza - no hint
pizza2 - pizza - no hint
plan1 - plan - no hint
portre1 - portrait - no hint
psikoloji1 - psychology - no hint
psikoloji2 - psychology - no hint
psikolog1 - psychologist - no hint
rejim1 - diet - no hint
restoran1 - restaurant - no hint
sürpriz1 - surprise - no hint
sembol1 - symbol - no hint
tablet1 - tablet - no hint
telefon1 - telephone - no hint
telefon2 - telephone - no hint
telefon3 - telephone - no hint
tenis1 - tennis - no hint
test1 - test - no hint
aktif1 - active - no hint
vazo1 - vase - no hint
vazo2 - vase - no hint
bakteri1 - bacteria - no hint
bar1 - bar - no hint
bar2 - bar - no hint
bar3 - bar - no hint
fizik1 - physics - no hint
piyano1 - piano - no hint
pilot1 - pilot - no hint
polis1 - police - no hint
profesyonel1 - professional - no hint
profesyonel2 - professional - no hint
profesyonel3 - professional - no hint
rapor1 - report - no hint
spekülasyon1 - speculation - no hint
spekülasyon2 - speculation - no hint
şeker1 - candy - no hint
süper1 - super - no hint
akademi1 - academy - no hint
aktris1 - actress - no hint
aktris2 - actress - no hint
avantaj1 - advantage - no hint
aritmetik1 - arithmetic - no hint
alfabe1 - alphabet - no hint
alfabe2 - alphabet - no hint
bisiklet1 - bike - no hint
bisiklet2 - bike - no hint
reaksiyon1 - reaction - no hint
sekreter1 - secretary - no hint
seks1 - sex - no hint
seks2 - sex - no hint
seks3 - sex - no hint
seks4 - sex - no hint
tuvalet1 - toilet - no hint
tuvalet2 - toilet - no hint
alternatif1 - alternative - no hint
amatör1 - amateur - no hint
trafik1 - traffic - no hint
tren1 - train - no hint
tren2 - train - no hint
antipatik1 - antipatik - no hint
astronot1 - astronaut - no hint
voleybol1 - volleyball - no hint
büyük1 - big - no hint
büyük2 - big - no hint
büyük3 - big - no hint
büyük4 - big - no hint
plastik1 - plastic - no hint
teori1 - theory - no hint
alkol1 - alcohol - no hint
tür1 - there - no hint
tür2 - there - no hint
tiyatro1 - theater - no hint
tiyatro2 - theater - no hint
aktör1 - actor - no hint
alarm1 - alarm - no hint
alarm2 - alarm - no hint
albüm1 - album - no hint
domates1 - tomato - no hint
domates2 - tomato - no hint
domates3 - tomato - no hint
domates4 - tomato - no hint
domates5 - tomato - no hint
domates6 - tomato - no hint
domates7 - tomato - no hint
ambulans1 - ambulance - no hint
ambulans2 - ambulance - no hint
ambulans3 - ambulance - no hint
ambulans4 - ambulance - no hint
iyi1 - good - no hint
iyi2 - good - no hint
iyi3 - good - no hint
iyi4 - good - no hint
bilmek1 - know - no hint
bilmek2 - know - no hint
bilmek3 - know - no hint
hapı yutmak1 - be in trouble - no hint
hapı yutmak2 - be in trouble - no hint
ellerine sağlık1 - god bless your hands - no hint
ağır - heavy - no hint
ağır1 - heavy - no hint
ağır2 - heavy - no hint
ekşi - sour - no hint
ekşi1 - sour - no hint
ekşi2 - sour - no hint
geç - late - no hint
geç1 - late - no hint
geç2 - late - no hint
emin - sure - no hint
emin1 - sure - no hint
emin2 - sure - no hint
sorumluluk - responsibility - no hint
sorumluluk1 - responsibility - no hint
lütfen oturun - please sit down - no hint
sen gelmesende olur - it will be fine even if you don't come - no hint
nerede olursa olsun onu mutlaka bulacağım - no matter where he is i'll definitely find him - no hint
şahsen - in person - no hint
böyle yani - so so - no hint
buz - ice - no hint
buz1 - ice - no hint
buz2 - ice - no hint
karşı - against - no hint
merkezi - center - no hint
merkezi1 - center - no hint
çamaşırlarımı çamaşır makinesine koydum - i put my laundry in the washing machine - no hint
mükemmel - perfect - no hint
mükemmel1 - perfect - no hint
mükemmel2 - perfect - no hint
bankamatik kartı - debit card - no hint
doğal - natural - no hint
doğmak - to be born - no hint
doğmak1 - to be born - no hint
domuz eti - pork - no hint
domuz eti1 - pork - no hint
farklı - different - no hint
dilek - wish - no hint
dilek1 - wish - no hint
dilek2 - wish - no hint
dilek3 - wish - no hint
dilek4 - wish - no hint
koca - husband - no hint
cümle - sentence - no hint
cümle1 - sentence - no hint
şaka - joke - no hint
şaka1 - joke - no hint
şaka2 - joke - no hint
akıllı - smart - no hint
akıllı1 - smart - no hint
kaba - rude - no hint
mutfak - kitchen - no hint
yüzde - percent - no hint
polis memuru - police officer - no hint
diziyi - series - no hint
güçlü - strong - no hint
güçlü1 - strong - no hint
serin - cool - no hint
sinirli - angry - no hint
özel - special - no hint
tip - tip - no hint
kadın - woman - no hint
kadın1 - woman - no hint
kadın2 - woman - no hint
kadın3 - woman - no hint
kadın4 - woman - no hint
kadın5 - woman - no hint
kadın6 - woman - no hint
kadın7 - woman - no hint
kadın8 - woman - no hint
place - yer - no hint
yerde - on the ground - no hint
aklına koyarsan kilo verebilirsin - you can lose weight if you set your mind to it - no hint
neredeyse alacakaranlık - almost twilight - no hint
başıma - by myself - no hint
olası - may possible - no hint
ağlamak - to cry - no hint
ağlamak1 - to cry - no hint
ağlamak2 - to cry - no hint
ağlamak3 - to cry - no hint
oynamak - to act in a film - no hint
kurşun kalem - pencil - no hint
bu eski bir kitap mı - is this an old book - no hint
görmek - see - no hint
görmek1 - see - no hint
ilgilendirmez - it is not relevant - no hint
anne - mother - no hint
anne1 - mother - no hint
anne2 - mother - no hint
anne3 - mother - no hint
anne4 - mother - no hint
anne5 - mother - no hint
anne6 - mother - no hint
anne7 - mother - no hint
anne8 - mother - no hint
anne9 - mother - no hint
arttı - has increased - no hint
aynı - same - no hint
aynı1 - same - no hint
bari - at least - no hint
bari1 - at least - no hint
antibiyotik - antibiotic - no hint
nbsp - soundsaint_enmp3 - no hint
sığır eti - beef - no hint
beklettiğim için özür dilerim - sorry to keep you waiting - no hint
genç - young - no hint
genç1 - young - no hint
genç2 - young - no hint
genç3 - young - no hint
genç4 - young - no hint
genç5 - young - no hint
genç6 - young - no hint
genç7 - young - no hint
bulut - cloud - no hint
bulut1 - cloud - no hint
bulut2 - cloud - no hint
 - soundorangesmp3 - no hint
nbsp - soundorangesmp3 - no hint
kar yağar - it snows - no hint
kare - square - no hint
kare1 - square - no hint
cep telefonu - mobile phone - no hint
çay - tea - no hint
çay1 - tea - no hint
çay2 - tea - no hint
çay3 - tea - no hint
çay4 - tea - no hint
çay5 - tea - no hint
çay6 - tea - no hint
çay7 - tea - no hint
çevirmeni - translator - no hint
pek - very - no hint
çıkarmak - to eject - no hint
kokuyor - it smells - no hint
inanmış - convinced - no hint
kadar iyi - as good as - no hint
bundan - from this - no hint
güneşli - sunny - no hint
demek - say - no hint
demek1 - say - no hint
demek2 - say - no hint
aramak - search - no hint
aramak2 - search - no hint
aramak3 - search - no hint
ciddi - serious - no hint
ciddi1 - serious - no hint
ciddi2 - serious - no hint
dün - yesterday - no hint
dün1 - yesterday - no hint
iç - inner - no hint
iç1 - inner - no hint
ekmek - bread - no hint
ekmek1 - bread - no hint
ekmek2 - bread - no hint
ekmek3 - bread - no hint
ekmek4 - bread - no hint
ekmek5 - bread - no hint
elbise - dress - no hint
elbise1 - dress - no hint
elektrik - electricity - no hint
eğlenmek - to have fun - no hint
eğlenmek1 - to have fun - no hint
erimek - to melt - no hint
eş - spouse - no hint
eş1 - spouse - no hint
ihtiyac - need - no hint
ihtiyac1 - need - no hint
bölüm - episode - no hint
sabah - sabah - no hint
sabah1 - sabah - no hint
beğenmek - to like - no hint
beğenmek1 - to like - no hint
beğenmek2 - to like - no hint
beğenmek3 - to like - no hint
ucuz - cheap - no hint
ucuz1 - cheap - no hint
ulaşmak - reach - no hint
öyle eyledi - brcommanded so - no hint
eylemek - command - no hint
kaygılı - disconcerting - no hint
mutlaka - absolutely - no hint
mutlaka1 - absolutely - no hint
egzersiz - exercise - no hint
bittiğinde - when finished - no hint
biz kazandık - we won - no hint
çıkmadım - i didn't go out - no hint
çıkamadım - i couldn't go out - no hint
genış - wide - no hint
gerisi - rest - no hint
geri kalan - the rest - no hint
geçirmek - spend time - no hint
gerekmek - to be required - no hint
gayet - well - no hint
nbsp - soundyou see_enmp3 - no hint
hapishane - prison - no hint
acımak - pity - no hint
gitmiştir - went event passed - no hint
hata - mistake - no hint
hata1 - mistake - no hint
hedef - target - no hint
hala - still - no hint
hala1 - still - no hint
hala2 - still - no hint
hala3 - still - no hint
hala4 - still - no hint
hala5 - still - no hint
hala6 - still - no hint
hala7 - still - no hint
hala8 - still - no hint
hala9 - still - no hint
bacak - leg - no hint
bacak1 - leg - no hint
ilaç almak - taking medicine - no hint
iletişim - contact - no hint
rüya görür - he dreams - no hint
kağıt - paper - no hint
kağıt1 - paper - no hint
kağıt2 - paper - no hint
kağıt3 - paper - no hint
kağıt4 - paper - no hint
kağıt5 - paper - no hint
kağıt6 - paper - no hint
kağıt7 - paper - no hint
kağıt8 - paper - no hint
kağıt9 - paper - no hint
yüksek sesli - loud - no hint
imkansız - impossible - no hint
onun yiyeceği yemek hazır - the food he is going to eat is ready - no hint
hm şimdi nereye gitsek - hm where should we go now - no hint
tekrar seyahat etmeye çok hazırım - i am very ready to travel again - no hint
hazır - ready - no hint
hazır1 - ready - no hint
hazır2 - ready - no hint
insan evrimi - human evolution - no hint
gergin - nervous - no hint
minnettarım - i appreciate - no hint
parmak - finger - no hint
parmak1 - finger - no hint
bâkir - virgincopper - no hint
kendime - myself - no hint
raflara göz gezdirdim - i looked over my shelves - no hint
makine - machine - no hint
makine1 - machine - no hint
makine2 - machine - no hint
gönderisi - post on the internet internet - no hint
ayrılmak - to leave - no hint
ayrılmak1 - to leave - no hint
sinyal - signal - no hint
ben olmasam - if i don't exist - no hint
dilemek - to wish - no hint
bakalım - let's see - no hint
imkan - possibility - no hint
imkan1 - possibility - no hint
kesinlikle - absolutely - no hint
kesinlikle1 - absolutely - no hint
hakkında - about - no hint
varsa - if there is - no hint
eğer - if - no hint
en iyi - best - no hint
şu anda - right now - no hint
bekar - single - no hint
bekar1 - single - no hint
bekar2 - single - no hint
bekar3 - single - no hint
hayırlısı olsun - hope the best - no hint
poşet - bag - no hint
poşet1 - bag - no hint
sakinleş - calm down - no hint
adam - man - no hint
adam1 - man - no hint
adam2 - man - no hint
adam3 - man - no hint
adam4 - man - no hint
adam5 - man - no hint
muhtemelen - probably - no hint
muhtemelen1 - probably - no hint
telaffuz - pronunciation - no hint
telaffuz1 - pronunciation - no hint
telaffuz2 - pronunciation - no hint
telaffuz3 - pronunciation - no hint
telaffuz4 - pronunciation - no hint
telaffuz5 - pronunciation - no hint
telaffuz6 - pronunciation - no hint
telaffuz7 - pronunciation - no hint
telaffuz8 - pronunciation - no hint
telaffuz9 - pronunciation - no hint
bebek yere düşer - the baby falls on the ground - no hint
yurtdışına - abroad - no hint
yeğen - niecenephew - no hint
yeğen1 - niecenephew - no hint
vücut - body - no hint
vücut1 - body - no hint
vücut2 - body - no hint
vücut3 - body - no hint
kılmak - make - no hint
pandemiye - pandemic - no hint
kafa - head - no hint
kafa1 - head - no hint
kafa2 - head - no hint
tuzlu - salty - no hint
içi içine sığmamak - very excited happy - no hint
yapmak - make - no hint
uyumak - to sleep - no hint
bağlıdır - it depends on - no hint
pansiyon - hostel - no hint
pansiyon1 - hostel - no hint
çıkış - exit - no hint
çorap - socks - no hint
çorap1 - socks - no hint
umuyorum - i hope - no hint
kötü - bad - no hint
kötü1 - bad - no hint
kötü2 - bad - no hint
fena - bad - no hint
bulutlu - cloudy - no hint
soğuk - cold - no hint
soğuk1 - cold - no hint
soğuk2 - cold - no hint
soğuk3 - cold - no hint
soğuk4 - cold - no hint
soğuk5 - cold - no hint
soğuk6 - cold - no hint
kol - arm - no hint
kol1 - arm - no hint
kol2 - arm - no hint
öf gene - uh again - no hint
iyi - good - no hint
iyi1 - good - no hint
iyi2 - good - no hint
iyi3 - good - no hint
iyi4 - good - no hint
yakın - near - no hint
herkes onu sever - everyone loves her - no hint
hariç - excluding - no hint
erkek arkadaş - boyfriend - no hint
ikisi de - both - no hint
bu kötü haber - this is bad news - no hint
yaz - summer - no hint
yaz1 - summer - no hint
yaz2 - summer - no hint
sıradış - out of the ordinary - no hint
acımasız olmak - to be cruel - no hint
gerekmek - to be required - no hint
kaba - rude - no hint
bisiklet - bike - no hint
bisiklet1 - bike - no hint
bisiklet2 - bike - no hint
utangaç - shy - no hint
utangaç1 - shy - no hint
kahve - coffee - no hint
kahve1 - coffee - no hint
kahve2 - coffee - no hint
kahve3 - coffee - no hint
kahve4 - coffee - no hint
kahve5 - coffee - no hint
kahve6 - coffee - no hint
kahve7 - coffee - no hint
tuhaf - strange - no hint
yatağın altında - under the bed - no hint
uzun - long - no hint
etkilenmek - to be touchedimpressed - no hint
görünmek - seem - no hint
aksan - accent - no hint
aksan1 - accent - no hint
korkunç - terrible - no hint
ilginç - interesting - no hint
ilginç1 - interesting - no hint
kıyı - coast - no hint
kıyı1 - coast - no hint
büyük koltuk nerede - where's the big sofa - no hint
harika - fantastic - no hint
harika1 - fantastic - no hint
harika2 - fantastic - no hint
harika3 - fantastic - no hint
harika4 - fantastic - no hint
harika5 - fantastic - no hint
harika6 - fantastic - no hint
harika7 - fantastic - no hint
seni can kulağı ile dinliyorum - i'm listening to you carefully - no hint
hiçbir kitap çöpe atılmamalı - no book should be thrown away - no hint
jonglörlük - juggling - no hint
hokkabaz - juggler - no hint
öyle yani - thats what happened apparently - no hint
banyo - bathroom - no hint
banyo1 - bathroom - no hint
söylediğin - what you said - no hint
sebze - vegetables - no hint
kaybetmek - to lose - no hint
kaygılı - disconcerting - no hint
kimlik - id - no hint
kurmalıyım - i have to install - no hint
öğrendin - you learned - no hint
otobüs - bus - no hint
otobüs1 - bus - no hint
otobüs2 - bus - no hint
otobüs3 - bus - no hint
otobüs4 - bus - no hint
otobüs5 - bus - no hint
otobüs6 - bus - no hint
otobüs7 - bus - no hint
memnun - satisfied - no hint
liste - listing - no hint
bunu çok isterim - i would like that very much - no hint
evcil hayvan - pet - no hint
kız arkadaş - girlfriend - no hint
yürüyüş yolu harika - walking path is great - no hint
biraz sonra muhtemelen tenis ya da koşarak egzersiz yapacağım - in a little bit i will probably exercise either tennis or running - no hint
hayallerinde - in your dreams - no hint
belirgin kılıyordu - making him stand out - no hint
iyisindir - you are fine - no hint
ilk kavşaktan sağa dön - turn right at the first roundabout - no hint
balığınızın bir adı var mı - does your fish have a name - no hint
yardım edin - help - no hint
yardım edin1 - help - no hint
yardım edin2 - help - no hint
sevdiğim başka bir diziyi hatırladım - i remembered another series i like - no hint
ingilizcenden - from your english - no hint
iyidir senden - fine you response to naber - no hint
gibi geliyor - sounds like - no hint
en utandırıcı anı bir sırdır - his most embarrassing memory is a secret - no hint
türkçem göründüğü kadar iyi değil - my turkish is not as good as it seems - no hint
türkçem göründüğünden daha iyi - my turkish is better than it seems - no hint
sonraki durak nedir - what is the next stop - no hint
dediğimi - what i said - no hint
yakında bir arama yapmak için müsait olacağım - i will be available soon to do a call - no hint
dükkan saat altıdan sonra kapanır - the store is closed after six o'clock - no hint
bunun için - for this - no hint
ona yalan söylemek en kötüsü - lying to her is the worst - no hint
şimdiye kadar iyi - good so far - no hint
bu kulağa daha iyi geliyor - this sounds better - no hint
ne yazık ki - unfortunately - no hint
ne yazık ki1 - unfortunately - no hint
neredensin - where are you from - no hint
neredensin1 - where are you from - no hint
söylediğin korkunç birşey - something terrible you said - no hint
lezzetli - delicious - no hint
özür - apology - no hint
ünlü - famous - no hint
ünlü1 - famous - no hint
ünlü2 - famous - no hint
ünlü3 - famous - no hint
macera - adventure - no hint
macera1 - adventure - no hint
erkek evlat - son - no hint
masanın üstünde - on the table - no hint
meyve - fruit - no hint
meyve1 - fruit - no hint
meyve2 - fruit - no hint
meyve3 - fruit - no hint
mide - measure - no hint
mide1 - measure - no hint
gitmam olası - i may go - no hint
mimarlık - architecture - no hint
evli - the married - no hint
mümkün - might - no hint
müzisyen - musician - no hint
müzisyen1 - musician - no hint
mundar etmeden - without rendering it useless - no hint
mücadele etmek - combat - no hint
mutfağı - kitchen as an object - no hint
mühendis - engineer - no hint
mühendis1 - engineer - no hint
mühendis2 - engineer - no hint
mühendis3 - engineer - no hint
mühendis4 - engineer - no hint
mühendis5 - engineer - no hint
mühendis6 - engineer - no hint
mühendis7 - engineer - no hint
mühendis8 - engineer - no hint
kolay - easy - no hint
kolay1 - easy - no hint
kolay2 - easy - no hint
sevdiğimi son bir kez yakından göreyim - let me see my beloved up close for the last time - no hint
geçtiğini - has passed - no hint
türkçem olduğundan daha iyi görünüyor - my turkish seems better than it is - no hint
kendine hakim olmak zor - selfcontrol is hard - no hint
neyse - anyways - no hint
neyse söyliyim bari - let me just say anyway - no hint
etmek - render - no hint
oraya - there - no hint
çocuklarım için - for my children - no hint
para vermek - giving money - no hint
bu - this - no hint
yeni - new - no hint
yukarı çıkıyor - is going up - no hint
elmalı pie krema ile servis edilir - apple pie served with cream - no hint
asansör yukarı çıkıyor - the elevator is going up - no hint
söylemek - say - no hint
görmek - to see - no hint
gece dışarı çıkmak - go out at night - no hint
gelmek - come - no hint
yemek - eat - no hint
her kış kayak yapmaya giderler - they go skiing every winter - no hint
yarın yapılacak çok şey yok - there aren't many things to be done tomorrow - no hint
çok şey - many things - no hint
onların - their - no hint
hiçbir - no - no hint
insan - human - no hint
en - most - no hint
kadar - until - no hint
daha - more - no hint
onların kızı çok şeker - their daughter is so adorable - no hint
ekmek masanın üstünde - the bread is on the table - no hint
benim evim ırmağa yakın - my house is near the river - no hint
onu anlayan sadece sensin - you're the only one who understands it - no hint
öğleden önce - before noon - no hint
ne zaman - what time - no hint
o yöne - that way - no hint
bunların kutusu kırmızı - their box is red - no hint
bu gece çok karanlık - it's very dark tonight - no hint
herhangi bir kız olabilir - she could be any girl - no hint
bir - one - no hint
bu hediye anne ve baba niçin - this present is for your parents - no hint
evin içinde - in the house - no hint
o iyi bir arkadaş - she's a good friend - no hint
için - for - no hint
kullanmak - use - no hint
sıcak görünüyor - looks hot - no hint
yakından göreyim - let me see up close - no hint
sorun para vermek değil - giving money isn't the problem - no hint
çıkmak - go out - no hint
akşam yemeğini mutfakta yiyoruz - we are eating dinner in the kitchen - no hint
her kış - every winter - no hint
senin adın ne - what's your name - no hint
bizim adetlerimiz sıradışı - our traditions are extraordinary - no hint
çok - many - no hint
bu hediye - this present - no hint
daha güzel - more beautiful - no hint
biz - we - no hint
bu kazak küçük boy - the sweater is small size - no hint
onların kızı - their daughter - no hint
kendine hakim olmak - self control - no hint
üstü - on - no hint
yeni bir saat - a new watch - no hint
içine - into - no hint
benim - my - no hint
iyi oynuyor - is playing well - no hint
olası - may - no hint
arkadaş olur - become friends - no hint
gelecek yıl geri geliyorum - i'm coming back next year - no hint
sonra - after - no hint
akşam yemeğinden sonra kahve içer - she drinks coffee after dinner - no hint
saat altıdan sonra - after six - no hint
en güzel - most beautiful - no hint
evimiz okyanusun yakınında - our home is by the ocean - no hint
o yöne gitti - he went that way - no hint
evin içine - into the house - no hint
şimdi oraya gideceğim - i'll go there now - no hint
her duyduğunu tekrar etmek iyi bir şey değildir - it's not a good thing to repeat everything you hear - no hint
her duyduğunu tekrar etmek - repeating everything you hear - no hint
bugün dışarısı sıcak görünüyor - it looks hot outside today - no hint
yapmak - make - no hint
o bilgisayarı kullanma - don't use that computer - no hint
mutfakta yiyoruz - are eating in the kitchen - no hint
onu sever - loves - no hint
dener şeyler - things said - no hint
gibi - like - no hint
sadece istemek - just want - no hint
içmek - drink - no hint
üç bilet satın aldım - i got three tickets - no hint
bu hediye benim mi - is this present mine - no hint
küçük - small - no hint
bu ev daha güzel - this house is more beautiful - no hint
senin adın - your name - no hint
onlar - they - no hint
bizim - our - no hint
ben sadece - i am just - no hint
her - every - no hint
benimle dans etmek - to dance with me - no hint
ben - i - no hint
kedi yatağın altında - the cat is under the bed - no hint
ile - with - no hint
yarına yemek yapacağım - i'll cook dinner for tomorrow - no hint
yere düşer - falls on the ground - no hint
mümkün - might - no hint
altı - under - no hint
zaman - time - no hint
yapmak - do - no hint
onun - his - no hint
onlar gittiyse bende gideyim - if they are gone i should go as well - no hint
onlar geri gelmezse - if they don't return - no hint
en utandırıcı - most embarrassing - no hint
sadece bir gece - just one night - no hint
ben olmasam daha mutlu olursun - you will be happier if i don't exist - no hint
benim ilk günüm - my first day - no hint
köpek evin içinde koşuyor - the dog is running into the house - no hint
bunlar - these - no hint
benim evim - my house - no hint
önce - before - no hint
ona yalan söylemek - lying to her - no hint
olmak - become - no hint
bugün - today - no hint
bugün de güneşli olacak - today will be sunny as well - no hint
akşam yemeğinden sonra - after dinner - no hint
takım iyi oynuyor - the team is playing well - no hint
şimdi ayrılıyoruz - we are leaving now - no hint
biz şimdi ayrılıyoruz - we're leaving now - no hint
içi - in - no hint
onun - her - no hint
ödevi yapmak - to do homework - no hint
sabaha kadar - until morning - no hint
sabaha kadar vaktim var - i have time until morning - no hint
benim değil - not mine - no hint
hoşlanmak - like - no hint
kitabı al - take the book - no hint
bilgisayarı kullanma - don't use the computer - no hint
duymak - to hear - no hint
vermek - give - no hint
ipek gibi - like silk - no hint
hayaletler gerçekten var - ghosts really exist - no hint
her şey sadece istemekle olmaz - not everything can be done with just wanting - no hint
satın almak - buy - no hint
dün dener şeyler bugün unutulur - things said yesterday are forgotten today - no hint
gece dışarı çıkmak iyi bir şey değil - it's not a good thing to go out at night - no hint
görmek - see - no hint
ben sadece fakir bir adamım - i am just a poor man - no hint
sen - you - no hint
senin - your - no hint
şimdi - now - no hint
benimle dans etmek ister misin - would you like to dance with me - no hint
küçük boy - small size - no hint
saçı onu belirgin kılıyordu - his hair was making him stand out - no hint
kendi - self - no hint
sadece bir gece kalıyoruz - we're staying just one night - no hint
yakınında - by - no hint
dün - yesterday - no hint
dün sabah - yesterday morning - no hint
yeni bir saat istiyorum - i want a new watch - no hint
onun çantası - his bag - no hint
büyük koltuk - big sofa - no hint
bunların kutusu - their box - no hint
onun çantası ağır - his bag is heavy - no hint
güneşli bir gün - it's a sunny day - no hint
kötü haber - bad news - no hint
onu yere düşürmek - dropping it on the ground - no hint
belki yağmur yağar - maybe it will rain - no hint
yukarı - up - no hint
buraya ne zaman geleceksin - when will you come here - no hint
kötü - bad - no hint
çikolatayı severim ama pasta sevmem - i like chocolate but i don't like cake - no hint
onun telefonu yine - her phone is new - no hint
gelecek yıl - next year - no hint
bugün de - today as well - no hint
her zaman saat beşte yemek yapar - he always makes dinner at pm - no hint
çalışmak - work - no hint
hiç anlayamıyorum - cannot understand at all - no hint
ofise geliyor - is coming to the office - no hint
sahip olmak - own - no hint
bazen seni hiç anlayamıyorum - sometimes i cannot understand you at all - no hint
gerçekten var - really exist - no hint
her sabah kahve içerim - i drink coffee every morning - no hint
dükkana gidiyor - she is going to the store - no hint
o - it - no hint
hiçbir kitap - no book - no hint
dün sabah geldik - we came yesterday morning - no hint
yarın - tomorrow - no hint
büyük - big - no hint
kız kardeşim evin içinde - my sister is in the house - no hint
almak - take - no hint
yemek yapar - makes food - no hint
söylemek istediğin bir şey - something i want to say - no hint
bakmak ve görmek - looking and seeing - no hint
değil - not - no hint
tenisten hoşlanır mısın - do you like tennis - no hint
var - exist - no hint
demek - to say - no hint
eğer - if - no hint
eğer gidersen - if you go - no hint
burada benim ilk günüm - it's my first day here - no hint
iyi - good - no hint
ilk - first - no hint
sık sık - often - no hint
sık sık balık avlamaya - austin fishing - no hint
çok çalıştım ya - i really studied too much - no hint
raftaki kitabı al - take the book from the shelf - no hint
kahvaltı istiyorlar - i want breakfast - no hint
kahvaltı istiyorlar - they want breakfast - no hint
mavi değil - not blue - no hint
bazen ilaç almak tehlikelidir - taking medicine is dangerous sometimes - no hint
dükkana gidiyor - is going to the store - no hint
iyi bir araba sahibi değilsin - you don't have a nice car - no hint
bilmek - know - no hint
bilmiyorum - do not know - no hint
tenisten hoşlanır - likes tennis - no hint
saçları ipek gibi - her hair is like silk - no hint
bunu bana mı veriyorsun - are you giving this to me - no hint
çok karanlık - very dark - no hint
kırmızı veya beyaz - red or white - no hint
herhangi bir kız - any girl - no hint
buraya ne zaman - when here - no hint
gözlük takıyorum çünkü gözlerim bozuk - i'm wearing glasses because my eyes are bad - no hint
hangi kitabı - which book - no hint
bu benim değil - it's not mine - no hint
ha - oh - no hint
bir bardak kırmızı veya beyaz şarap içer misin - will you drink a glass of red or white wine - no hint
zaman - when - no hint
çalıştım ya - i really studied - no hint
kadın cumartesi günü çalışmak zorunda - the woman has to work on saturday - no hint
bakmak ve görmek farklı şeylerdir - looking and seeing are different things - no hint
satın aldım - got - no hint
sevmek - love - no hint
sana söylemek istediğim bir şey var - there's something i want to say to you - no hint
daha iyi olur - it's better - no hint
kahve içerim - drink coffee - no hint
veriyorsun - are giving - no hint
gitmek - go - no hint
onları bilmiyorum - i don't know them - no hint
istemek - want - no hint
çok - very - no hint
krema ile - with cream - no hint
gün - day - no hint
randevunuzu ne zaman almak istersiniz - when would you like to schedule your appointment - no hint
hm - hm - no hint
onun telefonu - her phone - no hint
geceleyin gerçekten soğuk - it's really cold at night - no hint
kendin hakkında bahset - tell me about yourself - no hint
tabii olur onu yiyebilirsiniz - of course you can eat that - no hint
bu nedir - what is it - no hint
neden - why - no hint
gerçekten soğuk - really cold - no hint
onun neden kaçtığını sordum - i asked why she ran away - no hint
kim - whom - no hint
neden kaçtığını - why he ran away - no hint
oraya nasıl gidilir - how did you get there - no hint
anlamak - understand - no hint
cumartesi günü çalışmak - working on saturday - no hint
spor yapsan daha iyi olur - it's better if you do sports - no hint
kırmızı kalem istiyoruz mavi değil - we want red pencils not blue - no hint
iyi - well - no hint
güneşli bir gün - a sunny day - no hint
ha unutmadan şunu al - oh before i forget take this - no hint
çocuklarım için her şeyi yaparım - i'll do everything for my children - no hint
şu - that - no hint
iyi bir arkadaş - a good friend - no hint
gerçekten - really - no hint
herhangi - any - no hint
belki - maybe - no hint
ha unutmadan - oh before i forget - no hint
nerede olursa olsun - no matter where he is - no hint
onu yere düşürmek kolay - dropping it on the ground is easy - no hint
şunu açıklamadan - without explaining that - no hint
sık sık balık avlamaya çıkarım - i often go fishing - no hint
şimdi oraya - now there - no hint
buraya - hear - no hint
hava güneşli olduğu zaman mutluyum - i'm happy when it's sunny - no hint
tüm dükkanlar şimdi kapalı - all the shops are closed now - no hint
ne zaman - when - no hint
abim ve ablam - my older brother and sister - no hint
nedir - what is - no hint
veya - or - no hint
kimden - from whom - no hint
hakkında - about - no hint
be - much - no hint
ad - name - no hint
hangi - which - no hint
onun yiyeceği yemek - the food he is going to eat - no hint
öğretmen bile - even the teacher - no hint
bu ve şu - this and that - no hint
eh - um - no hint
nasıl gidilir - how to go - no hint
belki yağmur - maybe rain - no hint
ama pasta sevmem - but i don't like cake - no hint
hm şimdi - hm now - no hint
çok yedim be - i ate so much - no hint
nerede - where - no hint
ve - and - no hint
abim ve ablam doktordur - my brother and sisters are doctors - no hint
ne zaman almak - when to schedule - no hint
sadece - just - no hint
eğer gidersen ben de giderim - if you go i'll go - no hint
ne çok yedin be - you ate so much - no hint
güneşli olduğu zaman - when it's sunny - no hint
bunu kimden duydun - who did you hear this from - no hint
çünkü - because - no hint
hangi kitabı okudun - which book did you read - no hint
olmak - to be - no hint
öğretmen bile geç kaldı - even the teacher is late - no hint
tabii - sure - no hint
ne - what - no hint
tüm dükkanlar - all shops - no hint
ile - even - no hint
bunu ödemeden - without paying this - no hint
ama - but - no hint
o - she - no hint
tabii olur - of course - no hint
kendin hakkında - about yourself - no hint
tüm - all - no hint
nasıl - how - no hint
kullanım - use - no hint
süre - time - no hint
gerçek - real - no hint
yakın - near - no hint
bölüm - episode - no hint
altında - under - no hint
dava - case - no hint
şehir - city - no hint
ağaç - tree - no hint
heyecanlandırmak - excite - no hint
hayat - life - no hint
bilim - science - no hint
yemek - food - no hint
arkadaşı - his friend - no hint
başladı - started - no hint
mektup - letter - no hint
olağan - usual - no hint
dünya - world - no hint
umut - hope - no hint
ofis - office - no hint
yapılan - made - no hint
adam - adam - no hint
bana - to me - no hint
cümle - sentence - no hint
farklı - different - no hint
orada - there - no hint
yazmak - write - no hint
uzun - long - no hint
şey - thing - no hint
süt - milk - no hint
var - where - no hint
bak - behind - no hint
olabilir - could be - no hint
okul - school - no hint
büyümek - grow - no hint
güneş - sun - no hint
dört - four - no hint
devlet - state - no hint
yüzyıl - century - no hint
run - run - no hint
gece - night - no hint
kuzey - north - no hint
tehlike - danger - no hint
meyve - fruit - no hint
oda - room - no hint
kalın - thick - no hint
birlikte - together - no hint
sonraki - next - no hint
örnek - sample - no hint
demiryolu - railway - no hint
kilometre - kilometer - no hint
bakım - maintenance - no hint
düz - straight - no hint
kız - girl - no hint
keskin - sharp - no hint
almak - receive - no hint
yer - place - no hint
tam - tam - no hint
ölmek - die - no hint
sonra - then - no hint
sesi - session - no hint
yıl - year - no hint
geldi - came - no hint
bayan - lady - no hint
adı - first name - no hint
formu - form - no hint
karıştırmak - confuse - no hint
hat - has - no hint
bahçe - garden - no hint
sağ - right - no hint
çocuk - child - no hint
diye - that - no hint
başka - another - no hint
kırdı - broke - no hint
senin - monday - no hint
ölçek - scale - no hint
ulus - nation - no hint
ödeme - payment - no hint
elbise - dress - no hint
çağrı - call - no hint
yan - yan - no hint
metal - metal - no hint
çalışma - work - no hint
gıda - food - no hint
tutulan - held - no hint
saç - hair - no hint
aşçı - chef - no hint
zemin - floor - no hint
göz - eye - no hint
asla - never - no hint
çapraz - cross - no hint
çiftlik - farm - no hint
deniz - sea - no hint
çizmek - to draw - no hint
geç - late - no hint
parmak - finger - no hint
değeri - the value of - no hint
basın - press - no hint
yalan - lie - no hint
yendi - he won - no hint
az - the - no hint
görünüm - view - no hint
sandalye - chair - no hint
fikir - idea - no hint
dur - hard - no hint
ayrı - separate - no hint
duymak - hear - no hint
at - horse - no hint
ahşap - wooden - no hint
ana - mother - no hint
açık - open - no hint
kimin - whose - no hint
göstermektedir - shows - no hint
her - her - no hint
hayal - dream - no hint
ayaklar - feet - no hint
nazik - kind - no hint
gerekli - necessary - no hint
genç - young - no hint
hazır - ready - no hint
yukarıdaki - above - no hint
kırmızı - red - no hint
kapalı - closed - no hint
bizi - us - no hint
çiçek - flower - no hint
iş - business - no hint
satır - line - no hint
olsun - anyway - no hint
ağız - mouth - no hint
sembol - symbol - no hint
canlı - alive - no hint
sorun - problem - no hint
geri - back - no hint
molası - break - no hint
avlu - courtyard - no hint
yükselecek - will rise - no hint
darbe - coup - no hint
yağ - oil - no hint
yüzde - percent - no hint
düşünmek - think - no hint
demek - say - no hint
yardım - help - no hint
düşük - low - no hint
kahverengi - brown - no hint
giymek - to wear - no hint
dönüş - return - no hint
neden - why is that - no hint
seçim - selection - no hint
adil - fair - no hint
eski - old - no hint
aynı - same - no hint
kontrolü - control - no hint
onları - them - no hint
would - would - no hint
ünsüz - consonant - no hint
hız - speed - no hint
yaş - age - no hint
gel - the people - no hint
hayır - no - no hint
insanlar - people - no hint
benim - just me - no hint
üzerinde - over - no hint
demir - iron - no hint
tek - single - no hint
kim - kim - no hint
gülümseme - smile - no hint
oldu - it happened - no hint
kırışık - wrinkled - no hint
kafa - head - no hint
sayfa - page - no hint
gerekir - must - no hint
bulundu - was found - no hint
cevap - reply - no hint
çözmek - solve - no hint
it - it - no hint
hala - still - no hint
öğrenmek - learn - no hint
bitki - plant - no hint
kapak - cover - no hint
tutmak - keep - no hint
sonuç - result - no hint
yanmak - burn - no hint
let - let - no hint
tipi - types - no hint
hukuk - law - no hint
sert - hard - no hint
başlangıç - start - no hint
sahil - coast - no hint
kum - godfather - no hint
sol - sun - no hint
rulo - roll - no hint
doğal - natural - no hint
duyu - sense - no hint
kitap - book - no hint
aldı - took - no hint
zengin - rich - no hint
asker - soldier - no hint
süreç - process - no hint
dağ - mountain - no hint
lütfen - please - no hint
izle - watch - no hint
renk - color - no hint
yüz - face - no hint
öğrenci - student - no hint
köşe - corner - no hint
görünmek - seem - no hint
besleme - feed - no hint
yerleştirmek - place - no hint
beyaz - white - no hint
dönemi - period - no hint
kolaylığı - ease of - no hint
bu - it - no hint
etkisi - effect - no hint
nehir - river - no hint
araba - car - no hint
ikinci - second - no hint
kanat - kanat - no hint
komşu - neighbor - no hint
yarasa - bat - no hint
yerine - instead - no hint
listesi - list - no hint
yakında - soon - no hint
arazi - land - no hint
tür - kind - no hint
geçmiş - past - no hint
ev - home - no hint
denemek - try - no hint
hava - air - no hint
ay - ay - no hint
nokta - dot - no hint
mutlu - happy - no hint
öz - own - no hint
baba - father - no hint
gezi - travel - no hint
yuvarlak - round - no hint
tohum - seed - no hint
katılmak - join - no hint
gösterisi - show - no hint
büyüdü - has grown - no hint
tel - phone - no hint
maliyet - cost - no hint
kaybetti - lost - no hint
eşit - equal - no hint
gönderildi - sent - no hint
yani - so - no hint
düştü - fell - no hint
uygun - appropriate - no hint
hareket - movement - no hint
akış - flow - no hint
banka - bank - no hint
toplamak - collect - no hint
kulak - ear - no hint
oldukça - quite - no hint
yol - way - no hint
oğlu - son - no hint
birçok - many - no hint
yüksek - high - no hint
bahar - bahar - no hint
gibi - as - no hint
onu - her - no hint
sözlük - dictionary - no hint
bulut - cloud - no hint
sürpriz - surprise - no hint
sessiz - quiet - no hint
yaptım - i did - no hint
serin - cool - no hint
dizayn - design - no hint
anahtar - key - no hint
mayis - may - no hint
aşağı - down - no hint
cilt - skin - no hint
delik - hole - no hint
bulmak - find - no hint
atlama - jump - no hint
standı - stand - no hint
kendi - own - no hint
karşılamak - meet - no hint
yükseltmek - raise - no hint
paragraf - paragraph - no hint
üçüncü - third - no hint
tanımlamak - define - no hint
arasında - between - no hint
ya - yes - no hint
tepe - hill - no hint
düşünce - idea - no hint
kedi - cat - no hint
kopya - copy - no hint
hikaye - story - no hint
testere - saw - no hint
taşımak - transport - no hint
balık - the fish - no hint
işletmek - operate - no hint
uygulama - application - no hint
baz - base - no hint
kesim - cut - no hint
emin - sure - no hint
çağdaş - contemporary - no hint
halka - ring - no hint
karakter - character - no hint
başla - start - no hint
böcek - insect - no hint
yürümek - walk - no hint
radyo - radio - no hint
grup - group - no hint
atomudur - is the atom - no hint
müzik - music - no hint
elektrik - electricity - no hint
sık - stylish - no hint
kemik - bone - no hint
katılıyorum - i agree - no hint
kadın - woman - no hint
sanırım - i think - no hint
yıkama - washing - no hint
hiç - no - no hint
olsa - though - no hint
hissetmek - to feel - no hint
tartışma - discussion - no hint
kuş - bird - no hint
çan - bell - no hint
vücut - body - no hint
büyü - magic - no hint
hatta - even - no hint
kurulu - board - no hint
sevinç - joy - no hint
böyle - such - no hint
izleyin - watch - no hint
sormak - ask - no hint
değişim - change - no hint
yumuşak - soft - no hint
parlak - bright - no hint
resim - picture - no hint
gaz - gas - no hint
tekrar - again - no hint
hayvan - animal - no hint
bitirmek - finish - no hint
inşa - construction - no hint
giydirmek - dress up - no hint
toprak - soil - no hint
gitti - gone - no hint
ticaret - trade - no hint
bağırmak - yell - no hint
yazdı - wrote - no hint
temiz - clean - no hint
dokunma - do not touch - no hint
takım - team - no hint
kaydetmek - to save - no hint
ondalık - decimal - no hint
orta - middle - no hint
öldürmek - kill - no hint
göl - lake - no hint
gözlemlemek - to observe - no hint
iki - to - no hint
organ - organ - no hint
taş - rock - no hint
numarası - its number - no hint
ses - his - no hint
tırmanış - climb - no hint
sopa - soup - no hint
bebek - baby - no hint
sekiz - eight - no hint
köy - bay - no hint
kök - kitchen - no hint
ülke - country - no hint
satın - buy - no hint
gelecek hafta zamanım var - i have time next week - no hint
yedi - seven - no hint
bit - bit - no hint
ifade - expression - no hint
kavga - fight - no hint
olmaz - no way - no hint
zor - hard - no hint
doktor - doctor - no hint
korumak - protect - no hint
öğlen - noon - no hint
kırpma - clipping - no hint
eleman - workman - no hint
parti - set off - no hint
yakalandı - caught - no hint
konuştu - he spoke - no hint
geçmişi - history - no hint
işareti - sign - no hint
bekliyoruz - we are waiting - no hint
kaptan - captain - no hint
yeterli - enough - no hint
mısır - egypt - no hint
dize - string - no hint
köpek - dog - no hint
adım - step - no hint
aşk - love - no hint
kural - rule - no hint
soğuk - cold - no hint
koymak - put - no hint
dilek - wish - no hint
yazılı - written - no hint
enstrüman - instrument - no hint
inek - cow - no hint
erkekler - men - no hint
gerek - need - no hint
milyon - million - no hint
melodi - melody - no hint
yöntem - method - no hint
küçücük - tiny - no hint
deneme - trial - no hint
alt - everything - no hint
yirmi - twenty - no hint
güvenli - safe - no hint
sıcaklık - temperature - no hint
sağlamak - provide - no hint
böylece - thus - no hint
şiir - poetry - no hint
bağlı - connected - no hint
inch - inch - no hint
lastik - tire - no hint
boya - paint - no hint
kurşun - bullet - no hint
ağlamak - cry - no hint
durdu - stoped - no hint
içeren - including - no hint
oh - oh - no hint
hızlı - fast - no hint
hatırlıyorum - i remember - no hint
özellikle - especially - no hint
savaş - war - no hint
molekülü - molecule - no hint
kişi - person - no hint
para - money - no hint
görünür - appears - no hint
tuz - salt - no hint
öfke - anger - no hint
haber - news - no hint
iddia - allegation - no hint
oynamak - play - no hint
yalnız - only - no hint
okumak - reading - no hint
liman - port - no hint
catch - catch - no hint
ekleyin - add - no hint
gökyüzü - sky - no hint
burada - here - no hint
vahşi - wild - no hint
tuttu - known - no hint
kenar - edge - no hint
ayı - bear - no hint
garip - strange - no hint
kan - may - no hint
shall - acak - no hint
kalabalık - crowded - no hint
poz - item - no hint
geçmek - pass - no hint
beri - since - no hint
üst - top - no hint
sokak - street - no hint
varmak - arrive - no hint
çarpmak - bump - no hint
ders - lesson - no hint
getirdi - brought - no hint
ince - thin - no hint
çözüm - solution - no hint
makine - machine - no hint
kutu - box - no hint
elma - apple - no hint
bant - band - no hint
kayma - slip - no hint
geliştirmek - develop - no hint
duydum - i heard - no hint
beş - five - no hint
erken - early - no hint
tutun - tobacco - no hint
fiil - verb - no hint
dinle - listen - no hint
doğru - right - no hint
desen - drawing - no hint
merkezi - central - no hint
sütun - column - no hint
harita - map - no hint
idare - administration - no hint
çoğul - plural - no hint
kıta - continent - no hint
ayrıca - also - no hint
yaz - summer - no hint
kanıtlamak - prove - no hint
bacak - leg - no hint
egzersiz - exercise - no hint
el - the - no hint
kış - winter - no hint
ışık - light - no hint
ziyareti - visit - no hint
eğlenceli - funny - no hint
bunun için zamanim yok - i have time for this - no hint
doğrudan - direct - no hint
tüp - tube - no hint
rakam - rakam - no hint
kaya - so - no hint
biliyordu - he knew - no hint
usta - master - no hint
kalmak - stay - no hint
nesne - object - no hint
yüzey - surface - no hint
sistem - system - no hint
kayıt - record - no hint
tekne - boat - no hint
mümkün - possible - no hint
başkasının - someone else - no hint
bin - am - no hint
sıcak - hot - no hint
özledim - i missed - no hint
konuşma - talk - no hint
getirmek - to bring - no hint
evet - yes - no hint
kasaba - town - no hint
ölüm - death - no hint
düşmek - fall - no hint
teşekkür - thank - no hint
notu - grade - no hint
bekleyin - wait - no hint
planı - plan - no hint
yıldız - star - no hint
korkuyor - afraid - no hint
yetenekli - talented - no hint
bitti - over - no hint
sürücü - driver - no hint
ön - you - no hint
öğretmek - to teach - no hint
hafta - week - no hint
yeşil - green - no hint
ücretsiz - free - no hint
arkasında - behind - no hint
uzay - space - no hint
devam - continue - no hint
bloğu - block - no hint
saat - moment - no hint
olay - event - no hint
anlaşma - contract - no hint
yüzmek - to swim - no hint
faiz - interest - no hint
ulaşmak - reach - no hint
düzenlemek - arrange - no hint
şarkı - song - no hint
icat - invention - no hint
altı - six - no hint
seyahat - travel - no hint
dokuz - nine - no hint
basit - simple - no hint
birkaç - a few - no hint
ünlü - famous - no hint
atmak - throw away - no hint
yavaş - slow - no hint
mülkiyet - ownership - no hint
hizmet - service - no hint
gri - gray - no hint
gerektirir - requires - no hint
geniş - large - no hint
yağmur - rain - no hint
hazırlamak - prepare - no hint
çek - check - no hint
enerji - energy - no hint
yelken - sail - no hint
söyle - say it - no hint
istiyorum - i want - no hint
yarış - race - no hint
penceresi - window - no hint
tren - train - no hint
duvar - wall - no hint
cts - cts - no hint
onun söylediği kadar iyi değil - not as good as he said - no hint
ürün - product - no hint
siyah - black - no hint
kısa - short - no hint
gezegen - planet - no hint
sınıf - class - no hint
soru - question - no hint
olur - would be - no hint
gemi - ship - no hint
yarım - my love - no hint
taze - fresh - no hint
arama - search - no hint
sipariş - order - no hint
güney - south - no hint
parça - piece - no hint
çöl - desert - no hint
iz - from - no hint
tekerlek - wheel - no hint
levha - plate - no hint
madde - matter - no hint
kuvvet - force - no hint
mavi - blue - no hint
sonrası - post - no hint
harcamak - spend - no hint
derin - deep - no hint
ayak - foot - no hint
payı - share of - no hint
istasyon - station - no hint
meşgul - busy - no hint
test - test - no hint
şarj - charge - no hint
ortak - partner - no hint
altın - gold - no hint
teklif - bid - no hint
düzlem - plane - no hint
köle - slave - no hint
wonder - just - no hint
gülmek - laugh - no hint
derecesi - degree of - no hint
doldurmak - fill - no hint
kontrol - control - no hint
oyunu - game - no hint
şekil - figure - no hint
içki - drink - no hint
meydana - occur - no hint
destek - support - no hint
ısı - heat - no hint
sıvı - liquid - no hint
uzak - far - no hint
doldurun - fill in - no hint
doğu - east - no hint
dişler - teeth - no hint
güç - power - no hint
güzel - beautiful - no hint
belirli - specific - no hint
uçmak - fly - no hint
şube - branch - no hint
sonek - sonek - no hint
tartışmak - debate - no hint
kiloluk - pound - no hint
benzer - similar - no hint
kılavuz - guide - no hint
güzellik - beauty - no hint
puan - point - no hint
açtı - opened - no hint
zift - pitch - no hint
verdi - gave - no hint
halat - halat - no hint
okyanus - ocean - no hint
akşam - evening - no hint
güçlü - strong - no hint
zihin - mind - no hint
temel - basic - no hint
vadi - vadi - no hint
kuyruk - queue - no hint
grafiği - graph - no hint
şapka - hat - no hint
batı - west - no hint
karısı - his wife - no hint
omuz - shoulder - no hint
yaymak - radiate - no hint
tablo - chart - no hint
doğmuş - born - no hint
belirlemek - determine - no hint
sabah - sabah - no hint
kamyon - truck - no hint
gürültü - noise - no hint
şans - chance - no hint
dükkan - store - no hint
streç - stretch - no hint
parlaklık - brightness - no hint
yanlış - false - no hint
burun - nose - no hint
dedi - said - no hint
uyku - sleep - no hint
bir poşet alabilir miyim lütfen - can i have a sachet please - no hint
bundan bir tane lütfen - one of this please - no hint
eğer söyleyecek birşeyin varsa söyle - if you have something to say say - no hint
aile - family - no hint
bırakın - leave - no hint
ölçmek - to measure - no hint
kapı - door - no hint
görüş - opinion - no hint
acele - those - no hint
baş - head - no hint
rüzgar - wind - no hint
koloni - colony - no hint
mayın - may - no hint
komple - complete - no hint
kravat - tie - no hint
yangın - fire - no hint
izin - permission - no hint
akım - current - no hint
bütün - all - no hint
kral - king - no hint
ebeveyn - parent - no hint
iyilik - favor - no hint
bağlamak - connect - no hint
akor - chord - no hint
şişman - fat - no hint
ada - island - no hint
bar - bar - no hint
segmenti - segments - no hint
kuru - which one - no hint
anlık - instant - no hint
pazar - market - no hint
civciv - chick - no hint
düşman - foe - no hint
doğa - nature - no hint
kar - snow - no hint
buhar - steam - no hint
log - log - no hint
dil - the heart - no hint
ünitesi - unit - no hint
oksijen - oxygen - no hint
şeker - candy - no hint
karanlık - dark - no hint
maç - match - no hint
alan - domain - no hint
ceket - jacket - no hint
nihai - final - no hint
kitle - mass - no hint
win - win - no hint
dakika - minute - no hint
beslemek - nourish - no hint
aracı - tool - no hint
özel - special - no hint
üretmek - to produce - no hint
koltuk - armchair - no hint
çıkarmak - eject - no hint
karşısında - against - no hint
ayakkabı - shoe - no hint
kamp - camp - no hint
seviyesi - level - no hint
üzerinden - over - no hint
diğer - other - no hint
pozisyon - position - no hint
kol - col - no hint
yok - no - no hint
üç - three - no hint
oturmak - to sit - no hint
kaç derece - how many degrees - no hint
bu haftasonu sinemaya gideceğim - i will go to the cinema this weekend - no hint
bu haftasonu ne yapıyorsun - what are you doing this weekend - no hint
dans etmek ister misin - would you like to dance - no hint
ben değildim - it was not me - no hint
onlar telefonumu aldı - they took my phone - no hint
şansim arttı - my luck has increased - no hint
büyük bir şey değil - nothing big - no hint
ovmak - to kiss - no hint
korku - fear - no hint
üçgen - triangle - no hint
girin - enter - no hint
göndermek - send - no hint
sarı - yellow - no hint
söyledi - told - no hint
asansör - elevator - no hint
gül - rose - no hint
bölünme - division - no hint
memnun - satisfied - no hint
orijinal - original - no hint
ekmek - bread - no hint
ördek - duck - no hint
koştu - he ran - no hint
sevgili - dear - no hint
kabuk - shell - no hint
boyun - neck - no hint
beceri - skill - no hint
sezon - season - no hint
mıknatıs - magnet - no hint
gümüş - silver - no hint
incir - fig - no hint
kardeş - brother - no hint
çelik - steel - no hint
ileri - further - no hint
deneyim - experience - no hint
kart - map - no hint
rüya - dream - no hint
durumu - status - no hint
toplam - total - no hint
ne - born - no hint
çift - double - no hint
başarı - success - no hint
sırasında - during - no hint
şirket - company - no hint
pamuk - cotton - no hint
kuart - quart - no hint
kutu - can - no hint
henüz - yet - no hint
materyal - materiel - no hint
kesir - fraction - no hint
set - set - no hint
orman - forest - no hint
hobilerin ne - what are your hobbies - no hint
bu bize ilk gelişiniz mi - is this your first time for us - no hint
üzgünüm - sorry - no hint
nasılsın - how are you doing - no hint
çok yakışıklısın - you are so handsome - no hint
harika zaman geçiriyorum - having a great time - no hint
o anahtarlarını kaybetti - he lost his keys - no hint
burada benim iletişim bilgilerim bulunuyor - here is my contact information - no hint
şu nedir - what is that - no hint
bu nedir - what is this - no hint
sen bunu hak ettin - you deserved it - no hint
burada ne yapıyorsun - what are you doing here - no hint
dikkatli ol - be careful - no hint
yüzde yüz eminim - i am one hundred percent sure - no hint
utangaçım - i am shy - no hint
çok utandım - i was very embarrassed - no hint
et - and - no hint
dolar - dollar - no hint
akışı - flow - no hint
baskı - printing - no hint
aralığı - range - no hint
dalga - wave - no hint
do - do - no hint
çok düşüncelisin - you are very thoughtful - no hint
randevunuz var mı - do you have an appointment - no hint
kusara bakmayın tamamen doluyuz - excuse me we are full - no hint
biz sizi arayacağız - we will call you - no hint
su çok mu soğuk - is the water too cold - no hint
üç ile beş iş günü arasında sürer - takes between three and five working days - no hint
bir açıklama alabilir miyim lütfen - can i get an explanation please - no hint
bu hesabın yıllık ücreti var mı - does this account have an annual fee - no hint
cuma kar yağacak - it will snow on friday - no hint
yarın güneşli ve yağışlı olacak - tomorrow will be sunny and rainy - no hint
günün nasıldı - how was your day - no hint
akşam yemeğinde ne var - for dinner - no hint
beni affet lütfen - please forgive me - no hint
minnetkarım - memory card - no hint
merhaba - hello there - no hint
günaydın - good morning - no hint
kaç yaşındasın - how old are you - no hint
bir şey değil rica ederim - you are welcome - no hint
bir kez daha lütfen - one more time please - no hint
anlamadım - i did not understand - no hint
ben değiştim - changed - no hint
tekrar yapmayacağım - i will not do it again - no hint
başlamaya hazır mısınız - are you ready to start - no hint
seni seviyorum - i love you - no hint
o benim çantamdı - it was my bag - no hint
bir doktara ihtiyacım var - i need a doctor - no hint
polisi ara - call the police - no hint
herhangi bir kimliğiniz var mı acaba - do you have any identification - no hint
onun hakkında hala düşünüyorum - still thinking about her - no hint
ölü - dead - no hint
ağırlık - weight - no hint
vardı - had - no hint
top - top - no hint
kalp - heart - no hint
mevcut - available - no hint
olacak - it will be - no hint
motor - motor - no hint
öğleden önce burada ol - be here before noon - no hint
kaybınız için çok üzgünüm - so sorry for your loss - no hint
size içecek herhangi birşey getirebilirmiyim - can i get you anything to drink - no hint
yapmamalıydın - you have - no hint
hasta hissediyorum - i feel sick - no hint
nereye gitmek istersin - where do you want to go - no hint
size bırakıyorum - i leave it to you - no hint
sevdin mi - did you like - no hint
bu yeri arıyorum - looking for this place - no hint
para çekmek istiyorum - i want to withdraw money - no hint
geri git - go back - no hint
öksürüğüm var - i have a cough - no hint
doldu bile - already up - no hint
yaklaşık iki hafta - about two weeks - no hint
central otelde kalacağım - i will stay in central hotel - no hint
yazları sıcak mı - is it hot in summers - no hint
bir fırtına geliyor - a storm is coming - no hint
telefon numaran ne - your telephone number - no hint
kendini evinde hisset - feel at home - no hint
bu zor - difficult - no hint
bir araba kazası vardı - there was a car accident - no hint
fiş alabilir miyim lütfen - can i have a receipt please - no hint
tüm teşekkürlerim size - thank you all - no hint
bunbu yapamam - i do this - no hint
genel - general - no hint
daire - circle - no hint
içinde - in - no hint
keçe - felt - no hint
duyuyorum - i hear - no hint
boş zamanlarında ne yaparsın - what do you do in your spare time - no hint
tebrikler - congratulations - no hint
hoşgeldiniz - welcome - no hint
daha sonra tekrar gelebilir misin - can you come again later - no hint
harika görünüyor - looks great - no hint
para bozdurmak istiyorum - i want to change money - no hint
depozito yatırmak istiyorum - i want to make a deposit - no hint
bir hesap açtırmak istiyorum - i want to open an account - no hint
bu aciyor mu - does it hurt - no hint
bir sorun mu var - is there a problem - no hint
aile ziyareti için buradayım - here for a family visit - no hint
iş için buradayım - i am here for job - no hint
akşam yoğun yağış olacak - there will be heavy rain in the evening - no hint
akşamüzeri yağmur yağacak - it will rain in the evening - no hint
bütün gün yağmur yağdı - it rained all day - no hint
herkes nerede - where is everybody - no hint
teşekkür ederim - thank you - no hint
güle güle - good bye - no hint
ne zamandır görüşmüyoruz - how long have we not been meeting - no hint
harika - fantastic - no hint
leziz - delicious - no hint
severim - i like it - no hint
sevmem - i do not like - no hint
saat kaç - what time is it - no hint
tamam - ok - no hint
gerçekten mi - really - no hint
nerelisin - where are you from - no hint
bu senin için - this is for you - no hint
daha yavaş lütfen - slower please - no hint
yatak odası - bedroom - no hint
onlar - them - no hint
kelime - word - no hint
dahil - including - no hint
bölmek - divide - no hint
hece - syllable - no hint
ağır - heavy - no hint
öğle - noon - no hint
saat kaç senin için iyi - what time is it good for you - no hint
hiç çocuğun var mı - do you have any children - no hint
amerikalıyım - i am american - no hint
tatile mi gidiyorsun - are you going on vacation - no hint
harika görünüyorsun - you look amazing - no hint
buraya gitmek istiyorum - i want to go here - no hint
karın ağrım var - i have a stomachache - no hint
ateşim var - i have a fever - no hint
daha önce burada bulundunuz mu - have you been here before - no hint
yarın güneşli olacak - it will be sunny tomorrow - no hint
kışın hava nasıl - how is the weather in winter - no hint
akşamüzeri gökgürültülü sağanak yağış olacak - there will be thunderstorms in the evening - no hint
çok güzel bir gün - very nice day - no hint
ee yeni birşey var mı - so is there anything new - no hint
buğün nereye gittin - where did you go today - no hint
yarın ne yapıyorsun - what are you doing tomorrow - no hint
merak etme - do not worry - no hint
iyi akşamlar - good evening - no hint
ben iyiyim - fine - no hint
seçmek - choose - no hint
ani - years - no hint
dan - and - no hint
boyut - size - no hint
yerleşmek - settle down - no hint
çifti - pair - no hint
hadi yirmi dakika içinde gidelim - go in twenty minutes - no hint
altı gibi ayrılabilir miyiz - can we leave like six - no hint
saat üç - three - no hint
bende para yok - i have no money - no hint
alo - alo - no hint
tanıştığımıza memnun oldum - nice to to meet you - no hint
yumurta - egg - no hint
hücre - cell - no hint
uzunluk - length - no hint
temsil - representation - no hint
bölge - region - no hint
ancak - but - no hint
değiştirmek - change - no hint
bazı - some - no hint
olduğunu - is that - no hint
yarından sonraki gün cuma - the day after tomorrow is friday - no hint
görünüşe göre oraya varmak yaklaşık otuz dakika daha fazla sürecek - it will apparently take about thirty more minutes to get there - no hint
o şimdi gidiyor - he is going now - no hint
bunu daha önce yaptın mı - have you done this before - no hint
muhtemel - likely - no hint
yatak - bed - no hint
binmek - get on - no hint
inanıyorum - i believe - no hint
vardır - has - no hint
olmak - be - no hint
bir yanlış anlaşılma var - a misunderstanding - no hint
pazar olmuş bile - already sunday - no hint
otuz dakika içinde biter - ends in thirty minutes - no hint
uçak akşam varacak - the plane will arrive in the evening - no hint
olarak - as - no hint
sanat - art - no hint
tarafından - by - no hint
buz - ice - no hint
ingilizce konuşuyor musunuz - do you speak english - no hint
bunu nasıl düzeltebiliriz - how can we fix this - no hint
şimdi gidiyorum - going - no hint
tuvalet kağıdı yok - there is no toilet paper - no hint
televizyon çalışmıyor - television does not work - no hint
kahvaltı saat kaçta - what time is breakfast - no hint
bir rezervasyonum var - i have a reservation - no hint
sadece salı - only tuesday - no hint
o burada akşam yedi gibi olacak - it will be like seven evening here - no hint
otuz dakika erken varacağız - arrive thirty minutes early - no hint
avı - hunt - no hint
saymak - count - no hint
konu - subject - no hint
konuşmak - talk - no hint
beş kişilik bir masa - a table for five - no hint
kütüphanenin karşısındaki sokak - across the street from the library - no hint
rezervasyonunuz var mı acaba - do you have a reservation - no hint
kaç kişi acaba - i wonder how many people - no hint
bugün günlerden ne - what day is it today - no hint
biz birisi ile buluşuyoruz - we are meeting with someone - no hint
neye benziyorlardı - what were they like - no hint
arama yapabilir miyim - can i make a call - no hint
eğer birşeye ihtiyacın olursa beni ara - call me if you need anything - no hint
birşey ihtiyaciniz var mı - do you need anything - no hint
bu akşam döneceğim - be back tonight - no hint
bugün çarşamba - today is wednesday - no hint
o kırmızı bit gömlek ve kot pantalon giyiyordu - he was wearing a red bitcoin shirt and jeans - no hint
pazartesi haftanın en berbat günü - monday is the worst day of the week - no hint
karidese alerjim var - i am allergic to shrimp - no hint
çok fazla yedim - i ate too much - no hint
ne içmek istersiniz - what would you like to drink - no hint
tokum - tokum - no hint
bu ne kadar - how much is this - no hint
bunu alıcam - i will take this - no hint
lütfen oturun - please sit down - no hint
bana da aynısından - same to me - no hint
ne kadar sürer - how much will it take - no hint
bu o mu - is that it - no hint
bu ne tür bir yemek - what kind of food is this - no hint
bu yer nerde biliyor musunuz - do you know where is this place - no hint
havuz bugün açık mı - is the pool open today - no hint
ne yemek istersiniz - what do you want to eat - no hint
gerçekten çok iyi - really good - no hint
nereye gidiyoruz - where are we going - no hint
biraz süt alabilir miyim - can i have some milk - no hint
hesap - account - no hint
ikinci trafik ışıklarından sola dön - turn left at the second traffic light - no hint
kulağa harika geliyor - sounds great - no hint
çiçekler açıyor - flowers are blooming - no hint
araba ile gezmeye gitmek ister misin - do you want to go for a ride by car - no hint
futbol sever misin - do you like football - no hint
lütfen yazınız - please write - no hint
lütfen bir dakika bekleyin - please wait a minute - no hint
burada durun lütfen - stop here please - no hint
internete bağlanamıyorum - i connect to the internet - no hint
nereye gitmek istersiniz - where do you want to go - no hint
bir dakika bekleyiniz lütfen - wait a minute please - no hint
sonra tekrar deneyeceğim - try again later - no hint
nerdeyse vardık - almost we arrived - no hint
gitmek istemiyor gibiyim - i seem to want to go - no hint
çok üzücü - very sad - no hint
o acıtır - it hurts - no hint
buraya oturabilir miyim - can i sit here - no hint
hangi renk - what color - no hint
o gerçekten çok üzgün hissediyor - he feels really sad - no hint
bence yapabilirsin - i think you can do it - no hint
neredeyse yapmıştım - i almost did - no hint
kesinlikle komik değil - definitely not funny - no hint
onu düşündüğümde çok üzgün hissediyorum - when i think of her - no hint
iyi hissetmiyorum - i do not feel good - no hint
biliyorum - i know - no hint
endişeliyim - worried - no hint
ben kötü bir ruh hali içindeyim - in a bad mood - no hint
gerçekten gerginim - really nervous - no hint
beni yalnız bırak - leave me alone - no hint
bu seni ilgilendirmez - this is none of your business - no hint
bu1 - this - no hint
bu2 - this - no hint
bu3 - this - no hint
bu4 - this - no hint
görmek1 - to see - no hint
gelmek1 - come - no hint
gelmek2 - come - no hint
gelmek3 - come - no hint
yemek1 - eat - no hint
yemek2 - eat - no hint
onların1 - their - no hint
onların2 - their - no hint
hiçbir1 - no - no hint
insan1 - human - no hint
en1 - most - no hint
en2 - most - no hint
daha1 - more - no hint
bir1 - one - no hint
bir2 - one - no hint
bir3 - one - no hint
bir4 - one - no hint
bir5 - one - no hint
bir6 - one - no hint
bir7 - one - no hint
bir8 - one - no hint
çok1 - many - no hint
çok2 - many - no hint
çok3 - many - no hint
çok4 - many - no hint
çok5 - many - no hint
biz1 - we - no hint
benim1 - my - no hint
sonra1 - after - no hint
sonra2 - after - no hint
sonra3 - after - no hint
sonra4 - after - no hint
sonra5 - after - no hint
sonra6 - after - no hint
sonra7 - after - no hint
sonra8 - after - no hint
içmek1 - drink - no hint
küçük1 - small - no hint
küçük2 - small - no hint
onlar1 - they - no hint
onlar2 - they - no hint
onlar3 - they - no hint
onlar4 - they - no hint
onlar5 - they - no hint
bizim1 - our - no hint
her1 - every - no hint
ben1 - i - no hint
ben2 - i - no hint
ben3 - i - no hint
ben4 - i - no hint
ben5 - i - no hint
ile1 - with - no hint
altı1 - under - no hint
altı2 - under - no hint
altı3 - under - no hint
zaman1 - time - no hint
zaman2 - time - no hint
bunlar1 - these - no hint
olmak1 - become - no hint
olmak2 - become - no hint
olmak3 - become - no hint
bugün1 - today - no hint
bugün2 - today - no hint
içi1 - in - no hint
vermek1 - give - no hint
görmek1 - see - no hint
sen1 - you - no hint
sen2 - you - no hint
sen3 - you - no hint
sen4 - you - no hint
sen5 - you - no hint
senin1 - your - no hint
senin2 - your - no hint
şimdi1 - now - no hint
kendi1 - self - no hint
kendi2 - self - no hint
kendi3 - self - no hint
kendi4 - self - no hint
kendi5 - self - no hint
dün1 - yesterday - no hint
kötü1 - bad - no hint
kötü2 - bad - no hint
o1 - it - no hint
o2 - it - no hint
o3 - it - no hint
o4 - it - no hint
o5 - it - no hint
o6 - it - no hint
o7 - it - no hint
o8 - it - no hint
o9 - it - no hint
yarın1 - tomorrow - no hint
yarın2 - tomorrow - no hint
yarın3 - tomorrow - no hint
yarın4 - tomorrow - no hint
yarın5 - tomorrow - no hint
yarın6 - tomorrow - no hint
yarın7 - tomorrow - no hint
yarın8 - tomorrow - no hint
büyük1 - big - no hint
büyük2 - big - no hint
büyük3 - big - no hint
büyük4 - big - no hint
almak1 - take - no hint
almak2 - take - no hint
değil1 - not - no hint
değil2 - not - no hint
değil3 - not - no hint
değil4 - not - no hint
değil5 - not - no hint
değil6 - not - no hint
değil7 - not - no hint
değil8 - not - no hint
değil9 - not - no hint
var1 - exist - no hint
var2 - exist - no hint
var3 - exist - no hint
var4 - exist - no hint
demek1 - to say - no hint
demek2 - to say - no hint
iyi1 - good - no hint
iyi2 - good - no hint
iyi3 - good - no hint
iyi4 - good - no hint
bilmek1 - know - no hint
bilmek2 - know - no hint
bilmek3 - know - no hint
bilmiyorum1 - do not know - no hint
zaman1 - when - no hint
zaman2 - when - no hint
sevmek1 - love - no hint
gitmek1 - go - no hint
çok1 - very - no hint
çok2 - very - no hint
çok3 - very - no hint
çok4 - very - no hint
çok5 - very - no hint
gün1 - day - no hint
neden1 - why - no hint
neden2 - why - no hint
neden3 - why - no hint
kim1 - whom - no hint
kim2 - whom - no hint
anlamak1 - understand - no hint
anlamak2 - understand - no hint
anlamak3 - understand - no hint
iyi1 - well - no hint
iyi2 - well - no hint
iyi3 - well - no hint
iyi4 - well - no hint
şu1 - that - no hint
şu2 - that - no hint
şu3 - that - no hint
şu4 - that - no hint
şu5 - that - no hint
şu6 - that - no hint
şu7 - that - no hint
şu8 - that - no hint
şu9 - that - no hint
gerçekten1 - really - no hint
gerçekten2 - really - no hint
belki1 - maybe - no hint
belki2 - maybe - no hint
belki3 - maybe - no hint
veya1 - or - no hint
ad1 - name - no hint
ad2 - name - no hint
hangi1 - which - no hint
hangi2 - which - no hint
nerede1 - where - no hint
nerede2 - where - no hint
nerede3 - where - no hint
nerede4 - where - no hint
nerede5 - where - no hint
ve1 - and - no hint
ve2 - and - no hint
ve3 - and - no hint
sadece1 - just - no hint
sadece2 - just - no hint
sadece3 - just - no hint
olmak1 - to be - no hint
olmak2 - to be - no hint
olmak3 - to be - no hint
tabii1 - sure - no hint
tabii2 - sure - no hint
ne1 - what - no hint
ne2 - what - no hint
ne3 - what - no hint
ne4 - what - no hint
ile1 - even - no hint
ama1 - but - no hint
ama2 - but - no hint
ama3 - but - no hint
ama4 - but - no hint
ama5 - but - no hint
ama6 - but - no hint
o1 - she - no hint
o2 - she - no hint
o3 - she - no hint
o4 - she - no hint
o5 - she - no hint
o6 - she - no hint
o7 - she - no hint
o8 - she - no hint
o9 - she - no hint
tüm1 - all - no hint
nasıl1 - how - no hint
nasıl2 - how - no hint
nasıl3 - how - no hint
süre1 - time - no hint
dava1 - case - no hint
şehir1 - city - no hint
ağaç1 - tree - no hint
ağaç2 - tree - no hint
ağaç3 - tree - no hint
ağaç4 - tree - no hint
ağaç5 - tree - no hint
ağaç6 - tree - no hint
ağaç7 - tree - no hint
hayat1 - life - no hint
hayat2 - life - no hint
hayat4 - life - no hint
hayat5 - life - no hint
bilim2 - science - no hint
yemek1 - food - no hint
yemek2 - food - no hint
olağan1 - usual - no hint
dünya1 - world - no hint
dünya2 - world - no hint
umut1 - hope - no hint
umut2 - hope - no hint
umut3 - hope - no hint
umut4 - hope - no hint
adam1 - man - no hint
adam2 - man - no hint
adam3 - man - no hint
adam4 - man - no hint
adam5 - man - no hint
cümle1 - sentence - no hint
şey1 - thing - no hint
süt1 - milk - no hint
süt2 - milk - no hint
süt3 - milk - no hint
süt4 - milk - no hint
süt5 - milk - no hint
süt6 - milk - no hint
süt7 - milk - no hint
süt8 - milk - no hint
süt9 - milk - no hint
var1 - where - no hint
var2 - where - no hint
var3 - where - no hint
var4 - where - no hint
bak1 - behind - no hint
bak2 - behind - no hint
bak3 - behind - no hint
okul1 - school - no hint
okul2 - school - no hint
okul3 - school - no hint
okul4 - school - no hint
güneş1 - sun - no hint
güneş2 - sun - no hint
güneş3 - sun - no hint
güneş4 - sun - no hint
güneş5 - sun - no hint
güneş6 - sun - no hint
dört1 - four - no hint
dört2 - four - no hint
dört3 - four - no hint
devlet1 - state - no hint
gece1 - night - no hint
gece2 - night - no hint
kuzey1 - north - no hint
kuzey2 - north - no hint
kuzey3 - north - no hint
meyve1 - fruit - no hint
meyve2 - fruit - no hint
meyve3 - fruit - no hint
birlikte1 - together - no hint
bakım1 - maintenance - no hint
düz1 - straight - no hint
kız1 - girl - no hint
kız2 - girl - no hint
almak1 - receive - no hint
almak2 - receive - no hint
yer1 - place - no hint
yer2 - place - no hint
sonra1 - then - no hint
sonra2 - then - no hint
sonra3 - then - no hint
sonra4 - then - no hint
sonra5 - then - no hint
sonra6 - then - no hint
sonra7 - then - no hint
sonra8 - then - no hint
yıl1 - year - no hint
bayan1 - lady - no hint
bahçe1 - garden - no hint
bahçe2 - garden - no hint
bahçe3 - garden - no hint
bahçe4 - garden - no hint
bahçe5 - garden - no hint
bahçe6 - garden - no hint
bahçe7 - garden - no hint
bahçe8 - garden - no hint
çocuk1 - child - no hint
çocuk2 - child - no hint
çocuk3 - child - no hint
çocuk4 - child - no hint
çocuk5 - child - no hint
çocuk6 - child - no hint
diye1 - that - no hint
başka1 - another - no hint
başka2 - another - no hint
başka3 - another - no hint
senin1 - monday - no hint
senin2 - monday - no hint
ulus1 - nation - no hint
ulus2 - nation - no hint
elbise1 - dress - no hint
çağrı1 - call - no hint
çağrı2 - call - no hint
çalışma1 - work - no hint
saç1 - hair - no hint
saç2 - hair - no hint
aşçı1 - chef - no hint
aşçı2 - chef - no hint
göz1 - eye - no hint
asla1 - never - no hint
deniz1 - sea - no hint
deniz2 - sea - no hint
deniz3 - sea - no hint
geç1 - late - no hint
geç2 - late - no hint
parmak1 - finger - no hint
basın1 - press - no hint
görünüm1 - view - no hint
sandalye1 - chair - no hint
fikir1 - idea - no hint
ayrı1 - separate - no hint
at1 - horse - no hint
at2 - horse - no hint
at3 - horse - no hint
at4 - horse - no hint
at5 - horse - no hint
ahşap1 - wooden - no hint
ahşap2 - wooden - no hint
ana1 - mother - no hint
ana2 - mother - no hint
ana3 - mother - no hint
açık1 - open - no hint
kimin1 - whose - no hint
kimin2 - whose - no hint
her1 - her - no hint
hayal1 - dream - no hint
hayal2 - dream - no hint
ayaklar1 - feet - no hint
gerekli1 - necessary - no hint
genç1 - young - no hint
genç2 - young - no hint
genç3 - young - no hint
genç4 - young - no hint
genç5 - young - no hint
genç6 - young - no hint
genç7 - young - no hint
hazır1 - ready - no hint
hazır2 - ready - no hint
kırmızı1 - red - no hint
kırmızı2 - red - no hint
kırmızı3 - red - no hint
kırmızı4 - red - no hint
kırmızı5 - red - no hint
kırmızı6 - red - no hint
kırmızı7 - red - no hint
çiçek1 - flower - no hint
çiçek2 - flower - no hint
çiçek3 - flower - no hint
çiçek4 - flower - no hint
çiçek5 - flower - no hint
iş1 - business - no hint
iş2 - business - no hint
satır1 - line - no hint
ağız1 - mouth - no hint
ağız2 - mouth - no hint
ağız3 - mouth - no hint
sembol1 - symbol - no hint
canlı1 - alive - no hint
avlu1 - courtyard - no hint
yağ1 - oil - no hint
demek1 - say - no hint
demek2 - say - no hint
kahverengi1 - brown - no hint
kahverengi2 - brown - no hint
kahverengi3 - brown - no hint
kahverengi4 - brown - no hint
neden1 - why is that - no hint
neden2 - why is that - no hint
neden3 - why is that - no hint
adil1 - fair - no hint
adil2 - fair - no hint
eski1 - old - no hint
eski2 - old - no hint
aynı1 - same - no hint
an1 - moment - no hint
yaş1 - age - no hint
gel1 - the people - no hint
hayır1 - no - no hint
hayır2 - no - no hint
hayır3 - no - no hint
hayır4 - no - no hint
hayır5 - no - no hint
hayır6 - no - no hint
hayır7 - no - no hint
hayır8 - no - no hint
hayır9 - no - no hint
insanlar1 - people - no hint
benim1 - just me - no hint
üzerinde1 - over - no hint
kim1 - kim - no hint
kim2 - kim - no hint
oldu1 - it happened - no hint
oldu2 - it happened - no hint
oldu3 - it happened - no hint
kafa1 - head - no hint
kafa2 - head - no hint
sayfa1 - page - no hint
sayfa2 - page - no hint
cevap1 - reply - no hint
hala1 - still - no hint
hala2 - still - no hint
hala3 - still - no hint
hala4 - still - no hint
hala5 - still - no hint
hala6 - still - no hint
hala7 - still - no hint
hala8 - still - no hint
hala9 - still - no hint
öğrenmek1 - learn - no hint
öğrenmek2 - learn - no hint
öğrenmek3 - learn - no hint
öğrenmek4 - learn - no hint
hukuk1 - law - no hint
başlangıç1 - start - no hint
sahil1 - coast - no hint
sol1 - sun - no hint
kitap1 - book - no hint
kitap2 - book - no hint
kitap3 - book - no hint
kitap4 - book - no hint
kitap5 - book - no hint
kitap6 - book - no hint
kitap7 - book - no hint
asker1 - soldier - no hint
asker2 - soldier - no hint
asker3 - soldier - no hint
dağ1 - mountain - no hint
dağ2 - mountain - no hint
dağ3 - mountain - no hint
dağ4 - mountain - no hint
dağ5 - mountain - no hint
dağ6 - mountain - no hint
dağ7 - mountain - no hint
lütfen1 - please - no hint
lütfen2 - please - no hint
lütfen3 - please - no hint
lütfen4 - please - no hint
lütfen5 - please - no hint
lütfen6 - please - no hint
lütfen7 - please - no hint
lütfen8 - please - no hint
lütfen9 - please - no hint
renk1 - color - no hint
renk2 - color - no hint
yüz1 - face - no hint
yüz2 - face - no hint
öğrenci1 - student - no hint
öğrenci2 - student - no hint
köşe1 - corner - no hint
besleme1 - feed - no hint
besleme2 - feed - no hint
beyaz1 - white - no hint
beyaz2 - white - no hint
beyaz3 - white - no hint
beyaz4 - white - no hint
beyaz5 - white - no hint
beyaz6 - white - no hint
kâğıt1 - paper - no hint
kâğıt2 - paper - no hint
kâğıt3 - paper - no hint
kâğıt4 - paper - no hint
kâğıt5 - paper - no hint
kâğıt6 - paper - no hint
kâğıt7 - paper - no hint
kâğıt8 - paper - no hint
kâğıt9 - paper - no hint
bu1 - it - no hint
bu2 - it - no hint
bu3 - it - no hint
bu4 - it - no hint
nehir1 - river - no hint
nehir2 - river - no hint
nehir3 - river - no hint
nehir4 - river - no hint
nehir5 - river - no hint
nehir6 - river - no hint
nehir7 - river - no hint
araba1 - car - no hint
araba2 - car - no hint
araba3 - car - no hint
araba4 - car - no hint
araba5 - car - no hint
araba6 - car - no hint
araba7 - car - no hint
arazi1 - land - no hint
tür1 - kind - no hint
tür2 - kind - no hint
geçmiş1 - past - no hint
ev1 - home - no hint
hava1 - air - no hint
ay1 - ay - no hint
ay2 - ay - no hint
mutlu1 - happy - no hint
öz1 - own - no hint
baba1 - father - no hint
baba2 - father - no hint
baba3 - father - no hint
baba4 - father - no hint
baba5 - father - no hint
katılmak1 - join - no hint
katılmak2 - join - no hint
tel1 - phone - no hint
yani1 - so - no hint
yani2 - so - no hint
yani3 - so - no hint
uygun1 - appropriate - no hint
akış1 - flow - no hint
banka1 - bank - no hint
banka2 - bank - no hint
banka3 - bank - no hint
kulak1 - ear - no hint
kulak2 - ear - no hint
kulak3 - ear - no hint
oldukça1 - quite - no hint
yol1 - way - no hint
yol2 - way - no hint
bahar1 - bahar - no hint
onu1 - her - no hint
onu2 - her - no hint
sözlük1 - dictionary - no hint
bulut1 - cloud - no hint
bulut2 - cloud - no hint
sürpriz1 - surprise - no hint
sessiz1 - quiet - no hint
anahtar1 - key - no hint
anahtar2 - key - no hint
aşağı1 - down - no hint
delik1 - hole - no hint
kendi1 - own - no hint
kendi2 - own - no hint
kendi3 - own - no hint
kendi4 - own - no hint
kendi5 - own - no hint
paragraf1 - paragraph - no hint
düşünce1 - idea - no hint
kedi1 - cat - no hint
kedi2 - cat - no hint
kedi3 - cat - no hint
kedi4 - cat - no hint
hikaye1 - story - no hint
hikaye2 - story - no hint
hikaye3 - story - no hint
balık1 - the fish - no hint
balık2 - the fish - no hint
balık3 - the fish - no hint
balık4 - the fish - no hint
balık5 - the fish - no hint
balık6 - the fish - no hint
baz1 - base - no hint
emin1 - sure - no hint
emin2 - sure - no hint
çağdaş1 - contemporary - no hint
çağdaş2 - contemporary - no hint
böcek1 - insect - no hint
grup1 - group - no hint
müzik1 - music - no hint
müzik2 - music - no hint
sık1 - stylish - no hint
kemik1 - bone - no hint
kadın1 - woman - no hint
kadın2 - woman - no hint
kadın3 - woman - no hint
kadın4 - woman - no hint
kadın5 - woman - no hint
kadın6 - woman - no hint
kadın7 - woman - no hint
kadın8 - woman - no hint
sanırım1 - i think - no hint
hiç1 - no - no hint
kuş1 - bird - no hint
kuş2 - bird - no hint
kuş3 - bird - no hint
çan1 - bell - no hint
çan2 - bell - no hint
çan3 - bell - no hint
çan4 - bell - no hint
çan5 - bell - no hint
çan6 - bell - no hint
vücut1 - body - no hint
vücut2 - body - no hint
vücut3 - body - no hint
hatta1 - even - no hint
böyle1 - such - no hint
sormak1 - ask - no hint
resim1 - picture - no hint
resim2 - picture - no hint
resim3 - picture - no hint
hayvan1 - animal - no hint
toprak1 - soil - no hint
toprak2 - soil - no hint
bağırmak1 - yell - no hint
bağırmak2 - yell - no hint
kaydetmek1 - to save - no hint
göl1 - lake - no hint
göl2 - lake - no hint
göl3 - lake - no hint
iki1 - to - no hint
iki2 - to - no hint
iki3 - to - no hint
iki4 - to - no hint
taş1 - rock - no hint
taş2 - rock - no hint
taş3 - rock - no hint
ses1 - his - no hint
ses2 - his - no hint
ses3 - his - no hint
bebek1 - baby - no hint
bebek2 - baby - no hint
bebek3 - baby - no hint
bebek4 - baby - no hint
bebek5 - baby - no hint
sekiz1 - eight - no hint
sekiz2 - eight - no hint
köy1 - bay - no hint
kök1 - kitchen - no hint
ülke1 - country - no hint
yedi1 - seven - no hint
yedi2 - seven - no hint
yedi3 - seven - no hint
zor1 - hard - no hint
doktor1 - doctor - no hint
doktor2 - doctor - no hint
doktor3 - doctor - no hint
doktor4 - doctor - no hint
doktor5 - doctor - no hint
korumak1 - protect - no hint
kaptan1 - captain - no hint
mısır1 - egypt - no hint
mısır2 - egypt - no hint
köpek1 - dog - no hint
köpek2 - dog - no hint
köpek3 - dog - no hint
aşk1 - love - no hint
aşk2 - love - no hint
aşk3 - love - no hint
aşk4 - love - no hint
aşk5 - love - no hint
aşk6 - love - no hint
aşk7 - love - no hint
aşk8 - love - no hint
aşk9 - love - no hint
soğuk1 - cold - no hint
soğuk2 - cold - no hint
soğuk3 - cold - no hint
soğuk4 - cold - no hint
soğuk5 - cold - no hint
soğuk6 - cold - no hint
dilek1 - wish - no hint
dilek2 - wish - no hint
dilek3 - wish - no hint
dilek4 - wish - no hint
çim1 - grass - no hint
inek1 - cow - no hint
inek2 - cow - no hint
inek3 - cow - no hint
gerek1 - need - no hint
gerek2 - need - no hint
milyon1 - million - no hint
milyon2 - million - no hint
yöntem1 - method - no hint
deneme1 - trial - no hint
alt1 - everything - no hint
yirmi1 - twenty - no hint
yirmi2 - twenty - no hint
şiir1 - poetry - no hint
şiir2 - poetry - no hint
şiir3 - poetry - no hint
şiir4 - poetry - no hint
bağlı1 - connected - no hint
lastik1 - tire - no hint
lastik2 - tire - no hint
ağlamak1 - cry - no hint
ağlamak2 - cry - no hint
ağlamak3 - cry - no hint
hızlı1 - fast - no hint
savaş1 - war - no hint
kişi1 - person - no hint
para1 - money - no hint
para2 - money - no hint
para3 - money - no hint
para4 - money - no hint
para5 - money - no hint
tuz1 - salt - no hint
tuz2 - salt - no hint
tuz3 - salt - no hint
öfke1 - anger - no hint
öfke2 - anger - no hint
yalnız1 - only - no hint
okumak1 - reading - no hint
okumak2 - reading - no hint
okumak3 - reading - no hint
liman1 - port - no hint
gökyüzü1 - sky - no hint
gökyüzü2 - sky - no hint
gökyüzü3 - sky - no hint
vahşi1 - wild - no hint
ayı1 - bear - no hint
ayı2 - bear - no hint
kan1 - may - no hint
sokak1 - street - no hint
sokak2 - street - no hint
ince1 - thin - no hint
makine1 - machine - no hint
makine2 - machine - no hint
i3 - i - no hint
i4 - i - no hint
elma1 - apple - no hint
elma2 - apple - no hint
elma3 - apple - no hint
elma4 - apple - no hint
elma5 - apple - no hint
elma6 - apple - no hint
elma7 - apple - no hint
elma8 - apple - no hint
elma9 - apple - no hint
duydum1 - i heard - no hint
beş1 - five - no hint
beş2 - five - no hint
beş3 - five - no hint
tutun1 - tobacco - no hint
fiil1 - verb - no hint
dinle1 - listen - no hint
doğru1 - right - no hint
merkezi1 - central - no hint
harita1 - map - no hint
harita2 - map - no hint
harita3 - map - no hint
kıta1 - continent - no hint
ayrıca1 - also - no hint
yaz1 - summer - no hint
yaz2 - summer - no hint
bacak1 - leg - no hint
el1 - the - no hint
el2 - the - no hint
kış1 - winter - no hint
kış2 - winter - no hint
ışık1 - light - no hint
ışık2 - light - no hint
ışık3 - light - no hint
rakam1 - rakam - no hint
biliyordu1 - he knew - no hint
kayıt1 - record - no hint
bin1 - am - no hint
bin2 - am - no hint
sıcak1 - hot - no hint
sıcak2 - hot - no hint
evet1 - yes - no hint
evet2 - yes - no hint
evet3 - yes - no hint
evet4 - yes - no hint
evet5 - yes - no hint
evet6 - yes - no hint
evet7 - yes - no hint
evet8 - yes - no hint
evet9 - yes - no hint
ölüm1 - death - no hint
teşekkür1 - thank - no hint
yıldız1 - star - no hint
korkuyor1 - afraid - no hint
ön1 - you - no hint
ön2 - you - no hint
ön3 - you - no hint
ön4 - you - no hint
ön5 - you - no hint
öğretmek1 - to teach - no hint
hafta1 - week - no hint
yeşil1 - green - no hint
yeşil2 - green - no hint
yeşil3 - green - no hint
arkasında1 - behind - no hint
uzay1 - space - no hint
saat1 - moment - no hint
saat2 - hour - no hint
saat4 - hour - no hint
saat5 - hour - no hint
olay1 - event - no hint
anlaşma1 - contract - no hint
yüzmek1 - to swim - no hint
yüzmek2 - to swim - no hint
şarkı1 - song - no hint
şarkı2 - song - no hint
şarkı3 - song - no hint
altı1 - six - no hint
altı2 - six - no hint
altı3 - six - no hint
dokuz1 - nine - no hint
dokuz2 - nine - no hint
basit1 - simple - no hint
birkaç1 - a few - no hint
ünlü1 - famous - no hint
ünlü2 - famous - no hint
ünlü3 - famous - no hint
atmak1 - throw away - no hint
yavaş1 - slow - no hint
gri1 - gray - no hint
gri2 - gray - no hint
yağmur1 - rain - no hint
yağmur2 - rain - no hint
yağmur3 - rain - no hint
yağmur4 - rain - no hint
çek1 - check - no hint
söyle1 - say it - no hint
söyle2 - say it - no hint
tren1 - train - no hint
tren2 - train - no hint
ürün1 - product - no hint
siyah1 - black - no hint
siyah2 - black - no hint
siyah3 - black - no hint
kısa1 - short - no hint
sınıf1 - class - no hint
olur1 - would be - no hint
gemi1 - ship - no hint
gemi2 - ship - no hint
gemi3 - ship - no hint
yarım1 - my love - no hint
güney1 - south - no hint
güney2 - south - no hint
güney3 - south - no hint
tekerlek1 - wheel - no hint
levha1 - plate - no hint
mavi1 - blue - no hint
mavi2 - blue - no hint
mavi3 - blue - no hint
mavi4 - blue - no hint
mavi5 - blue - no hint
mavi6 - blue - no hint
mavi7 - blue - no hint
mavi8 - blue - no hint
derin1 - deep - no hint
derin2 - deep - no hint
ayak1 - foot - no hint
ayak2 - foot - no hint
ayak3 - foot - no hint
test1 - test - no hint
şarj1 - charge - no hint
köle1 - slave - no hint
acaba1 - wonder - no hint
acaba2 - wonder - no hint
acaba3 - wonder - no hint
gülmek1 - laugh - no hint
gülmek2 - laugh - no hint
şekil1 - figure - no hint
uzak1 - far - no hint
doğu1 - east - no hint
dişler1 - teeth - no hint
güç1 - power - no hint
güzel1 - beautiful - no hint
güzel2 - beautiful - no hint
güzel3 - beautiful - no hint
güzel4 - beautiful - no hint
güzel5 - beautiful - no hint
güzel6 - beautiful - no hint
güzel7 - beautiful - no hint
güzel8 - beautiful - no hint
güzel9 - beautiful - no hint
belirli1 - specific - no hint
uçmak1 - fly - no hint
kılavuz1 - guide - no hint
kılavuz2 - guide - no hint
kılavuz3 - guide - no hint
güzellik1 - beauty - no hint
verdi1 - gave - no hint
okyanus1 - ocean - no hint
akşam1 - evening - no hint
akşam2 - evening - no hint
akşam3 - evening - no hint
akşam4 - evening - no hint
akşam5 - evening - no hint
akşam6 - evening - no hint
güçlü1 - strong - no hint
temel1 - basic - no hint
şapka1 - hat - no hint
şapka2 - hat - no hint
batı1 - west - no hint
batı2 - west - no hint
belirlemek1 - determine - no hint
sabah1 - sabah - no hint
gürültü1 - noise - no hint
dükkan1 - store - no hint
dükkan2 - store - no hint
yanlış1 - false - no hint
burun1 - nose - no hint
burun2 - nose - no hint
burun3 - nose - no hint
burun4 - nose - no hint
uyku1 - sleep - no hint
uyku2 - sleep - no hint
aile1 - family - no hint
aile2 - family - no hint
aile3 - family - no hint
kapı1 - door - no hint
kapı2 - door - no hint
acele1 - those - no hint
baş1 - head - no hint
baş2 - head - no hint
baş3 - head - no hint
rüzgar1 - wind - no hint
rüzgar2 - wind - no hint
rüzgar3 - wind - no hint
rüzgar4 - wind - no hint
kravat1 - tie - no hint
yangın1 - fire - no hint
gun1 - gun - no hint
akım1 - current - no hint
bütün1 - all - no hint
bütün2 - all - no hint
bağlamak1 - connect - no hint
şişman1 - fat - no hint
ada1 - island - no hint
ada2 - island - no hint
ada3 - island - no hint
ada4 - island - no hint
ada5 - island - no hint
bar1 - bar - no hint
bar2 - bar - no hint
bar3 - bar - no hint
kuru1 - which one - no hint
pazar1 - market - no hint
pazar2 - market - no hint
pazar3 - market - no hint
pazar4 - market - no hint
pazar5 - market - no hint
dil1 - the heart - no hint
dil2 - the heart - no hint
dil3 - the heart - no hint
dil4 - the heart - no hint
oksijen1 - oxygen - no hint
şeker1 - candy - no hint
karanlık1 - dark - no hint
karanlık2 - dark - no hint
karanlık3 - dark - no hint
alan1 - domain - no hint
alan2 - domain - no hint
ceket1 - jacket - no hint
nihai1 - final - no hint
dakika1 - minute - no hint
beslemek1 - nourish - no hint
beslemek2 - nourish - no hint
aracı1 - tool - no hint
koltuk1 - armchair - no hint
ayakkabı1 - shoe - no hint
ayakkabı2 - shoe - no hint
kol1 - arm - no hint
kol2 - arm - no hint
yok1 - no - no hint
yok2 - no - no hint
üç1 - three - no hint
üç2 - three - no hint
üç3 - three - no hint
üç4 - three - no hint
oturmak1 - to sit - no hint
üçgen1 - triangle - no hint
göndermek1 - send - no hint
sarı1 - yellow - no hint
sarı2 - yellow - no hint
sarı3 - yellow - no hint
asansör1 - elevator - no hint
gül1 - rose - no hint
gül2 - rose - no hint
ekmek1 - bread - no hint
ekmek2 - bread - no hint
ekmek3 - bread - no hint
ekmek4 - bread - no hint
ekmek5 - bread - no hint
ördek1 - duck - no hint
ördek2 - duck - no hint
ördek3 - duck - no hint
sevgili1 - dear - no hint
sevgili2 - dear - no hint
sevgili3 - dear - no hint
sevgili4 - dear - no hint
sevgili5 - dear - no hint
sevgili6 - dear - no hint
sevgili7 - dear - no hint
beceri1 - skill - no hint
beceri2 - skill - no hint
incir1 - fig - no hint
kardeş1 - brother - no hint
kardeş2 - brother - no hint
ileri1 - further - no hint
rüya1 - dream - no hint
rüya2 - dream - no hint
rüya3 - dream - no hint
rüya4 - dream - no hint
rüya5 - dream - no hint
ne1 - born - no hint
ne2 - born - no hint
ne3 - born - no hint
ne4 - born - no hint
başarı1 - success - no hint
pamuk1 - cotton - no hint
henüz1 - yet - no hint
set1 - set - no hint
orman1 - forest - no hint
orman2 - forest - no hint
nasılsın1 - how are you doing - no hint
nasılsın2 - how are you doing - no hint
nasılsın3 - how are you doing - no hint
nasılsın4 - how are you doing - no hint
nasılsın5 - how are you doing - no hint
nasılsın6 - how are you doing - no hint
nasılsın7 - how are you doing - no hint
nasılsın8 - how are you doing - no hint
nasılsın9 - how are you doing - no hint
dikkatli ol1 - be careful - no hint
et1 - and - no hint
et2 - and - no hint
et3 - and - no hint
dolar1 - dollar - no hint
dolar2 - dollar - no hint
baskı1 - printing - no hint
merhaba1 - hello there - no hint
merhaba2 - hello there - no hint
merhaba3 - hello there - no hint
merhaba4 - hello there - no hint
merhaba5 - hello there - no hint
merhaba6 - hello there - no hint
merhaba7 - hello there - no hint
merhaba8 - hello there - no hint
merhaba9 - hello there - no hint
günaydın1 - good morning - no hint
günaydın2 - good morning - no hint
günaydın3 - good morning - no hint
günaydın4 - good morning - no hint
günaydın5 - good morning - no hint
günaydın6 - good morning - no hint
günaydın7 - good morning - no hint
günaydın8 - good morning - no hint
günaydın9 - good morning - no hint
kaç yaşındasın1 - how old are you - no hint
kaç yaşındasın2 - how old are you - no hint
kaç yaşındasın3 - how old are you - no hint
kaç yaşındasın4 - how old are you - no hint
kaç yaşındasın5 - how old are you - no hint
ağırlık1 - weight - no hint
top1 - top - no hint
top2 - top - no hint
kalp1 - heart - no hint
kalp2 - heart - no hint
daire1 - circle - no hint
tebrikler1 - congratulations - no hint
teşekkür ederim1 - thank you - no hint
teşekkür ederim2 - thank you - no hint
teşekkür ederim3 - thank you - no hint
teşekkür ederim4 - thank you - no hint
teşekkür ederim5 - thank you - no hint
teşekkür ederim6 - thank you - no hint
teşekkür ederim7 - thank you - no hint
teşekkür ederim8 - thank you - no hint
teşekkür ederim9 - thank you - no hint
güle güle1 - good bye - no hint
güle güle2 - good bye - no hint
güle güle3 - good bye - no hint
güle güle4 - good bye - no hint
güle güle5 - good bye - no hint
güle güle6 - good bye - no hint
güle güle7 - good bye - no hint
güle güle8 - good bye - no hint
güle güle9 - good bye - no hint
harika1 - fantastic - no hint
harika2 - fantastic - no hint
harika3 - fantastic - no hint
harika4 - fantastic - no hint
harika5 - fantastic - no hint
harika6 - fantastic - no hint
harika7 - fantastic - no hint
saat kaç1 - what time is it - no hint
saat kaç2 - what time is it - no hint
tamam1 - ok - no hint
tamam2 - ok - no hint
tamam3 - ok - no hint
tamam4 - ok - no hint
tamam5 - ok - no hint
tamam6 - ok - no hint
tamam7 - ok - no hint
nerelisin1 - where are you from - no hint
yatak odası1 - bedroom - no hint
yatak odası2 - bedroom - no hint
onlar1 - them - no hint
onlar2 - them - no hint
onlar3 - them - no hint
onlar4 - them - no hint
onlar5 - them - no hint
kelime1 - word - no hint
kelime2 - word - no hint
dahil1 - including - no hint
ağır1 - heavy - no hint
ağır2 - heavy - no hint
öğle1 - noon - no hint
iyi akşamlar1 - good evening - no hint
iyi akşamlar2 - good evening - no hint
ani1 - years - no hint
ani2 - years - no hint
ani3 - years - no hint
alo1 - alo - no hint
yumurta1 - egg - no hint
yumurta2 - egg - no hint
yumurta3 - egg - no hint
yumurta4 - egg - no hint
ancak1 - but - no hint
ancak2 - but - no hint
bazı1 - some - no hint
olduğunu1 - is that - no hint
muhtemel1 - likely - no hint
vardır1 - has - no hint
olmak1 - be - no hint
olmak2 - be - no hint
olmak3 - be - no hint
ben1 - i - no hint
ben2 - i - no hint
ben3 - i - no hint
ben4 - i - no hint
ben5 - i - no hint
sanat1 - art - no hint
sanat2 - art - no hint
sanat3 - art - no hint
sanat4 - art - no hint
sanat5 - art - no hint
tarafından1 - by - no hint
buz1 - ice - no hint
buz2 - ice - no hint
konuşmak1 - talk - no hint
konuşmak2 - talk - no hint
konuşmak3 - talk - no hint
konuşmak4 - talk - no hint
hesap1 - account - no hint
gündem - agenda - no hint
alkol - alcohol - no hint
altar - altar - no hint
yapay - artificial - no hint
denge - balance - no hint
acımasız - brutal - no hint
kablo - cable - no hint
kanal - channel - no hint
kanser - cancer - no hint
kanon - cannon - no hint
sermaye - capital - no hint
kömür - coal - no hint
karton - carton - no hint
beyin - brain - no hint
çikolata - chocolate - no hint
dairesel - circular - no hint
sivil - civilian - no hint
kulüp - club - no hint
yaka - collar - no hint
sömürge - colonial - no hint
koma - coma - no hint
yanma - combustion - no hint
bilinç bulanıklığı konfüzyon - confusion confusion - no hint
önemli - important - no hint
samimi - sincere - no hint
adli - judicial - no hint
kriz - crisis - no hint
kültürel - cultural - no hint
karar - decision - no hint
diyagonal - diagonal - no hint
yönetmen - director - no hint
disk - disk - no hint
dram - drama - no hint
dayanıklı - resistant - no hint
editoryal - editorial - no hint
muamma - enigma - no hint
hata - error - no hint
deneysel - experimental - no hint
patlama - explosion - no hint
ihraç - exportation - no hint
uzantı - extension - no hint
dış - teeth - no hint
faktör - factor - no hint
tanıdık - familiar - no hint
ölümcül - fatal - no hint
federal - federal - no hint
festival - festival - no hint
esnek - flexible - no hint
resmi - formal - no hint
formül - formula - no hint
önden - from the front - no hint
gala - gala - no hint
yaratılış - creation - no hint
küresel - spherical - no hint
mezar - tomb - no hint
alışılmış - usual - no hint
hobi - hobby - no hint
yatay - horizontal - no hint
hastane - hospital - no hint
otel - hotel - no hint
ideal - ideal - no hint
imparatorluk - empire - no hint
akın - influx - no hint
bireysel - individual - no hint
sanayi - industry - no hint
kaçınılmaz - inevitable - no hint
daha düşük - less than - no hint
gayri resmi - unofficial - no hint
ayrılmaz - inseparable - no hint
müfettiş - inspector - no hint
sonsuz - endless - no hint
istila - infestation - no hint
görünmez - invisible - no hint
düzensiz - irregular - no hint
kilo - weight - no hint
yanal - lateral - no hint
yasal - legal - no hint
yerel - local - no hint
erkek - male - no hint
mango - mango - no hint
mani - hands - no hint
manuel - manuel - no hint
marjinal - marginal - no hint
malzeme - material - no hint
evlilik - marriage - no hint
vasat - vasat - no hint
kavun - melon - no hint
zihinsel - mental - no hint
menü - menu - no hint
sefil - miserable - no hint
ahlaki - moral - no hint
ölümlü - positive - no hint
motel - motel - no hint
çoklu - multiple - no hint
müzikal - musical - no hint
asil - noble - no hint
normal - normal - no hint
nostalji - nostalgia - no hint
opera - opera - no hint
oral - oral - no hint
oryantal - oriental - no hint
panorama - panorama - no hint
makarna - pasta - no hint
papaz - priest - no hint
veranda - veranda - no hint
tuhaf - strange - no hint
ceza - criminal - no hint
kişiye özel - personal - no hint
plan - plan - no hint
plaza - plaza - no hint
popüler - popular - no hint
müdür - manager - no hint
propaganda - propaganda - no hint
koruyucu - protector - no hint
il - the - no hint
radikal - radical - no hint
bölgesel - local - no hint
düzenli - tidy - no hint
din - from - no hint
toplantı - meeting - no hint
revizyon - review - no hint
ritüel - ritual - no hint
kırsal - rural - no hint
laik - secular - no hint
duygusal - emotional - no hint
seri - series - no hint
cinsel - sexual - no hint
tekil - singular - no hint
sosyal - social - no hint
yıkma - destruction - no hint
yüzeysel - superficial - no hint
üstün - superior - no hint
taksi - taxi - no hint
televizyon - television - no hint
korkunç - terrible - no hint
terör - terror - no hint
transandantal - transcendental - no hint
üçlü - triple - no hint
tropikal - tropical - no hint
birlik - unity - no hint
evrensel - universal - no hint
sözlü - verbal - no hint
versiyon - version - no hint
dikey - vertical - no hint
vaktini boşa harcamak - waste your time - no hint
gözle görülür - visible - no hint
görsel - image - no hint
hayati - vital - no hint
kaba - rude - no hint
savunmasız - vulnerable - no hint
soyutlama - abstraction - no hint
aksiyon - action - no hint
suçlama - blame - no hint
adaptasyon - adaptation - no hint
hayranlık - admiration - no hint
takdir - discretion - no hint
bağlantı - connection - no hint
özlem - longing - no hint
dikkat - attention - no hint
cazibe - fascination - no hint
yetki - authority - no hint
kutlama - celebration - no hint
dolaşım - circulation - no hint
medeniyet - civilization - no hint
sınıflandırma - classification - no hint
işbirliği - cooperation - no hint
kombinasyon - combination - no hint
tazminat - compensation - no hint
kompozisyon - composition - no hint
konsantrasyon - concentration - no hint
anlayış - understanding - no hint
şart - must - no hint
koruma - protection - no hint
değerlendirme - evaluation - no hint
anayasa - constitution - no hint
sergileme - display - no hint
kurgu - fiction - no hint
eğitim - education - no hint
basitleştirme - simplification - no hint
ispanyol - spanish - no hint
yıldönümü - anniversary - no hint
keyfi - arbitrary - no hint
yorum - comment - no hint
tamamlayıcı - complement - no hint
tersine - backwards - no hint
günlük - daily - no hint
haliç - estuary - no hint
birincil - primary - no hint
tespih boncukları - rosary beads - no hint
maaş - salary - no hint
sekreter - secretary - no hint
kelime hazinesi - vocabulary - no hint
geçici - temporary - no hint
akademik - academic - no hint
alkollü - alcoholic - no hint
sanatsal - art - no hint
otantik - authentic - no hint
otomatik - automatic - no hint
karakteristik - characteristics - no hint
klasik - classical - no hint
komik - funny - no hint
demokratik - democratic - no hint
dinamik - dynamic - no hint
diplomatik - diplomatic - no hint
yerli - domestic - no hint
dramatik - dramatic - no hint
ekonomik - economic - no hint
elektronik - electronic - no hint
erotik - erotic - no hint
acayip - strange - no hint
fantastik - fantastic - no hint
genetik - genetic - no hint
geometrik - geometric - no hint
kahramanca - heroic - no hint
ironik - ironic - no hint
büyülü - magical - no hint
mozaik - mosaic - no hint
organik - organic - no hint
panik - panic - no hint
plastik - plastic - no hint
şiirsel - poetic - no hint
halka açık - public - no hint
romantik - romantic - no hint
sistematik - systematic - no hint
trajik - tragic - no hint
meraklı - curious - no hint
lezzetli - delicious - no hint
şanlı - famous - no hint
değerli - valuable - no hint
dini - religious - no hint
sıkıcı - boring - no hint
davranmak - behave - no hint
eser - work - no hint
kompakt - compact - no hint
fikir ayrılığı - conflict - no hint
iletişim - contact - no hint
kesinlikle - absolutely - no hint
dışında - outside - no hint
mükemmel - excellent - no hint
sorun ne - what is the problem - no hint
nasıl gidiyor - how39s it going - no hint
çok iyi - very good - no hint
şöyle böyle - so so - no hint
çok iyi değil - not so good - no hint
ya sen - what about you - no hint
benim ismim - my name - no hint
adınız ne - what is your name - no hint
zevk - taste - no hint
yer - ground - no hint
yarın görüşürüz - see you tomorrow - no hint
sonra görüşürüz - see you later - no hint
yakında görüşürüz arkadaşım - see you soon my friend - no hint
rica ederim - you39re welcome - no hint
affedersiniz - excuse me - no hint
afedersiniz - sorry - no hint
ne yapmak istersin - what do you want to do - no hint
mi en sevdiğim hobi - is it my favorite hobby - no hint
hobilerin neler - what are your hobbies - no hint
sen boş zamanlarında ne yaparsınız - what do you do in your spare time - no hint
beğendim beğenmedim - i like it i don39t like it - no hint
onu seviyorum - i love him - no hint
ne okumayı seversin - what do you like to read - no hint
ne tür müzik seversin - what kind of music do you like - no hint
benim favorim - my favourite - no hint
gitmeyi seviyorum - i like to go - no hint
işiniz nedir - what is your business - no hint
işini seviyor musun - do you like your job - no hint
çalışıyorum - i am working - no hint
ne kadar - how much - no hint
banyo nerede - where is the bathroom - no hint
bir şey olur - something happens - no hint
bu doğru mu - is this true - no hint
ben hatalıydım - i was wrong - no hint
bana bu konuda yardımcı olabilir misin - can you help me with this - no hint
bana getirebilir misin lütfen - can you bring me please - no hint
girebilirim - i can enter - no hint
bir şeyler içmek ister misin - do you want to drink something - no hint
nerede yemek yemeliyiz - where should we eat - no hint
hazır mısın - are you ready - no hint
onu görmeden ne kadar zamandır - how long before i saw him - no hint
iyi ki doğdun - happy birthday - no hint
iyi şanslar - good luck - no hint
sağlık - health - no hint
iyileşmek - heal - no hint
zevk almak - enjoy - no hint
kendine iyi bak - take care of yourself - no hint
aferin - well done - no hint
inanılmaz - unbelievable - no hint
bakalım - let39s see - no hint
diğer taraftan - on the other hand - no hint
aman tanrım - oh my god - no hint
yardıma ihtiyacım var - i need help - no hint
vardığında beni ara - call me when you arrive - no hint
eve gidiyorum - i39m going home - no hint
gitmem gerek - i have to go - no hint
oraya nasıl giderim - how can i go to there - no hint
hiçbir fikrim yok - i have no idea - no hint
anladın - you understand - no hint
anlayamıyorum - i can not understand - no hint
daha yavaş konuşabilir misin lütfen - can you speak slower please - no hint
itibaren - from - no hint
at - at - no hint
dırdir - dırdir - no hint
o - he - no hint
an - an - no hint
ben mi - ben mi - no hint
a - a - no hint
e - is - no hint
para - for - no hint
of - of - no hint
ada - there is - no hint
bir şey - something - no hint
sizin - your - no hint
hiçbir şey değil - nothing - no hint
bize - to us - no hint
tek başına - alone - no hint
olabilir miyim - can i be - no hint
öyleydi - it was - no hint
yapabilmek - be able to - no hint
bayım - sir - no hint
git - go - no hint
dsö - dsö - no hint
dahil - because - no hint
nereden - where from - no hint
hakikat - fact - no hint
ben idim - i was - no hint
daha iyi - better - no hint
niyet - intention - no hint
tanrı - god - no hint
olmadan - without - no hint
öyle mi - is that so - no hint
sr - sr - no hint
sonsuza dek - forever - no hint
hissediyorum - i am feeling - no hint
yapabilirsiniz - you can do - no hint
ni - ni - no hint
sahibiz - we have - no hint
bir şeyler - something - no hint
birisi - someone - no hint
biraz - some - no hint
ister - wants - no hint
kimse - nobody - no hint
anlaşılan - apperantly - no hint
görme - seeing - no hint
elbette - of course - no hint
onlarda var - they have - no hint
nınnin - of your - no hint
oradaydı - was there - no hint
bilirsin - you know - no hint
dışarıda - outside - no hint
sigorta - insurance - no hint
arkadaş - friend - no hint
günler - days - no hint
diyor - says - no hint
bok - book - no hint
anne - anne - no hint
baba - midwife - no hint
beklemek - wait - no hint
yapabiliriz - we can - no hint
dedim - i said - no hint
olmuştur - has been - no hint
daha az - less - no hint
zorunda - must - no hint
benimle - with me - no hint
zamanlar - times - no hint
herşey - everything - no hint
isim soyisim - name surname - no hint
sence - sence - no hint
görüldü - was seen - no hint
aranan - wanted - no hint
fark eder önemi var - it matters it does matter - no hint
bu kadar - so much - no hint
her biri - each one - no hint
seninle - with you - no hint
yap - do - no hint
duyar - hears - no hint
ah - ah - no hint
yapmalısın - you should - no hint
vay - borrow - no hint
yapacağım - i will do - no hint
sebep - reason - no hint
şunlar - those - no hint
anlıyorum - i understand - no hint
polis - police - no hint
yapılmış - made - no hint
arkadaşlar - friends - no hint
siz çocuklar - you guys - no hint
güldüm - i laughed - no hint
defol - get out - no hint
fatura - invoice - no hint
tatlım - sweetie - no hint
tamam mi - okay - no hint
hanım - lady - no hint
yapabilirler - they can - no hint
geceler - nights - no hint
dışarı - out - no hint
olması gerekiyor - it must be - no hint
biliyordum - i knew - no hint
şanslı - lucky - no hint
verir - gives - no hint
karşı - against - no hint
neredeyse - almost - no hint
bekle - wait - no hint
su - it's - no hint
çocuklar - children - no hint
dans - in - no hint
geçtim - i passed - no hint
malısın - you should - no hint
gelir - income - no hint
yapraklar - leaves - no hint
form - form - no hint
gözler - the eyes - no hint
kadın eş - wife - no hint
ileride - in the future - no hint
mano - mano - no hint
ben yaptım - i did - no hint
fakat - but - no hint
deli - deli - no hint
alma - soul - no hint
anladım - i understand - no hint
patron - boss - no hint
eller - or - no hint
sorunlar - problems - no hint
izin ver - let me - no hint
kendini - itself - no hint
yukarıda - above - no hint
diğerleri - others - no hint
kişiler - persons - no hint
konuşuyorum - i39m talking - no hint
son - his - no hint
kadin - woman - no hint
telefon etmek - call - no hint
konuşuyor - speaking - no hint
diyorsun - you say - no hint
saatler - watches - no hint
amca dayı - uncle - no hint
isterler - they want - no hint
zorunlu - compulsory - no hint
devam et - go on - no hint
yaparım - i do - no hint
anlamı - meaning - no hint
yaşamak - live - no hint
ihtiyacı olmak - to need - no hint
gittim - i went - no hint
oturum aç - sign in - no hint
numara - number - no hint
bu yeterli - that39s enough - no hint
onlar söylüyor - they say - no hint
şarap - wine - no hint
kız kardeş - sister - no hint
oğullar - sons - no hint
çiviler - nails - no hint
abilir - can - no hint
aylar - months - no hint
gerçeklik - reality - no hint
daha yüksek - higher - no hint
di - of - no hint
kalıntılar - ruins - no hint
tamam mı - okay - no hint
barış - peace - no hint
kuruş - penny - no hint
yaptı - made - no hint
boyalı - painted - no hint
bal - ball - no hint
gideceğim - i will go - no hint
suç - crime - no hint
kızlar - girls - no hint
biliyorlar - they know - no hint
kolay - easy - no hint
lanetlenmiş - damned - no hint
her ikisi de - both of them - no hint
endişelenmek - to worry - no hint
moron - moron - no hint
sahiptim - i had - no hint
sayın - dear - no hint
şeytanlar - demons - no hint
özlemek - miss - no hint
ihtiyacımız var - we need - no hint
nereye - where - no hint
gelirim - i come - no hint
eksiklik - lack - no hint
inanmak - believe - no hint
bence - in my opinion - no hint
ihtiyacın var - you need - no hint
işte - request - no hint
film - film - no hint
koca - husband - no hint
babalar - fathers - no hint
düşünme - thinking - no hint
orada olurdu - would be there - no hint
sense - sense - no hint
söyleyeceğim - i will say - no hint
yapabildin mi - could you handle it - no hint
o öldü - he died - no hint
kahve - coffee - no hint
taşır - carries - no hint
en son - in are - no hint
söyleme - don39t say - no hint
aranıyor - searching - no hint
kapa çeneni - shut up - no hint
iadeler - returns - no hint
silah - weapon - no hint
kayıp - lost - no hint
oyna - play - no hint
on - on - no hint
görürüz - we see - no hint
zar - zar - no hint
biliyoruz - we know - no hint
geri kalan - the rest - no hint
daha da kötüsü - worse - no hint
çekip gitmek - go away - no hint
gidiyor - going - no hint
yoksul - poor - no hint
giyim - clothing - no hint
istiyoruz - we want - no hint
aksi takdirde - otherwise - no hint
genç adam - young man - no hint
devlet başkanı - president - no hint
dün gece - last night - no hint
milyonlar - millions - no hint
beyler - gentlemen - no hint
haftalar - weeks - no hint
kelimeler - words - no hint
alın - take it - no hint
yaparız - we do - no hint
denizler - the seas - no hint
pazar tezgahı - market stall - no hint
kalıcı - permanent - no hint
pislik - dirt - no hint
silahlar - weaponry - no hint
iblisler - demons - no hint
nefret - hate - no hint
dinlenme - rest - no hint
ararım - i39ll call - no hint
kaybetmek - to lose - no hint
olacağım - i will be - no hint
güvenlik - security - no hint
yardım etmek - help - no hint
tüy - feather - no hint
muhtemelen - probably - no hint
dile - to the tongue - no hint
hatırlamak - remember - no hint
göreceksin - you will see - no hint
ben isterim - i want - no hint
aptal - silly - no hint
basitçe - simply - no hint
sorular - questions - no hint
bilinen - known - no hint
kağıt - paper - no hint
tedavi - treatment - no hint
onu gör - see it - no hint
aç - hungry - no hint
döndü - turned around - no hint
kırsal bölge - countryside - no hint
acaba - just - no hint
yaşıyor - is alive - no hint
inandım - i believed - no hint
banyo - bathroom - no hint
sana söyle - tell you - no hint
öğretmen - teacher - no hint
ağıt - lament - no hint
ona söyle - tell him - no hint
gizli - hidden - no hint
yapmalıyız - we have to do - no hint
onlar hoşlanıyor - they like - no hint
ödemek - pay - no hint
gelecek - the future - no hint
sessizlik - silence - no hint
çılgın - crazy - no hint
değişiklik - alteration - no hint
gösterdi - showed - no hint
gelin - bride - no hint
imkansız - impossible - no hint
derhal - immediately - no hint
izin vermek - to let - no hint
giyerim - i wear - no hint
uçak - airplane - no hint
sahip olacak - will have - no hint
takip etme - following - no hint
kazanmak - win - no hint
ağrı - ache - no hint
lanet - curse - no hint
durum - status - no hint
hasar - damage - no hint
hissediyorsun - you feel - no hint
anlaşıldı - it is understood - no hint
ordu - army - no hint
ona ver - ona ver - no hint
bitmiş - finished - no hint
sesler - sounds - no hint
suikastçı - conspirator - no hint
harikulade - wonderful - no hint
sıra - desk - no hint
seks - sex - no hint
seviyor - love - no hint
ileti - message - no hint
bilgi - information - no hint
takım elbise - suit - no hint
ruh - spirit - no hint
albay - colonel - no hint
dale - dale - no hint
fiyat - price - no hint
buldum - i found - no hint
sahip olacaksın - you will have - no hint
çağlar - ages - no hint
göt - ass - no hint
içeride - inside - no hint
hükümet - government - no hint
dediler - they said - no hint
medya - media - no hint
bizdik - tot - no hint
ben vereceğim - i will give - no hint
fotoğraf - photo - no hint
kaza - accident - no hint
işe yarıyor - it works - no hint
merkez - center - no hint
görünümünde - in view of - no hint
teğmen - lieutenant - no hint
ayrıldı - left - no hint
veririm - i give - no hint
aramalar - calls - no hint
mağaza - shop - no hint
noel - noel - no hint
adres - address - no hint
büyükanne - grandmother - no hint
etrafında - around - no hint
o geliyor - it comes - no hint
sahip olacağım - i will have - no hint
özgürlük - freedom - no hint
satış - sales - no hint
avukat - lawyer - no hint
geri vermek - give back - no hint
kâğıt - paper - no hint
yemin etmek - swear - no hint
yakışıklı - handsome - no hint
ilginç - interesting - no hint
dişi köpek - bitch - no hint
öldürüldü - killed - no hint
tamamen - completely - no hint
gelirler - they come - no hint
geldiğinde - when you come - no hint
büyükbaba - grandfather - no hint
senin varmi - have you - no hint
linda - linda - no hint
sahip olacağız - we will have - no hint
parçalar - parts - no hint
hapis - prison - no hint
onlar yaptı - they did - no hint
teyze - aunt - no hint
don - don - no hint
tarih - history - no hint
sahiptin - you had - no hint
kamera - camera - no hint
ajan - i drive - no hint
cehennem - hell - no hint
vasıtasıyla - by - no hint
bana söyle - tell me - no hint
çavuş - sergeant - no hint
ayrılmak - leave - no hint
seninki - yours - no hint
bunların her ikisi de - both of these - no hint
sakin ol - calm down - no hint
çöp - garbage - no hint
kariyer - career - no hint
doğum günü - birthday - no hint
bir süre - for a while - no hint
biz gideceğiz - we will go - no hint
kolej - college - no hint
dans etmek - dancing - no hint
üzgün - sad - no hint
kilise - the church - no hint
önünde - in front of - no hint
bulur - finds - no hint
varsayar - assumes - no hint
program - program - no hint
kutsal - sacred - no hint
erkek arkadaş - boyfriend - no hint
şaka - joke - no hint
söyleyebilirim - i can tell - no hint
o ayrıldı - he left - no hint
isa - isa - no hint
söz veriyorum - i promise - no hint
soruyorum - i am asking - no hint
geri gel - come back - no hint
akşam yemegi - dinner - no hint
oluştu - formed - no hint
koşar - runs - no hint
bahaneler - excuses - no hint
sen gel - you come - no hint
bira - beer - no hint
düşünülmüş - considered - no hint
hedef - target - no hint
fotoğraflar - photos - no hint
şeytan - satan - no hint
döneceğim - i will come - no hint
biliyor - he knows - no hint
cennet - paradise - no hint
oturma odası - living room - no hint
emirler - orders - no hint
göre - by - no hint
yapacaksın - you will - no hint
saldırı - attack - no hint
paris - paris - no hint
misal - example - no hint
bakma - do not look - no hint
şüphe - doubt - no hint
düğün - wedding - no hint
istedim - i wanted - no hint
sen istedin - you wanted - no hint
kraliçe - queen - no hint
tahmin etmiştim - i guessed - no hint
yerler - places - no hint
faliyet alani sahne - scene - no hint
cinayet - murder - no hint
inşaat sahası - construction site - no hint
göreceğim - i will see - no hint
sonuçlanmak - end up - no hint
arzu etmek - desire - no hint
kanıt - evidence - no hint
efendim - sir - no hint
beni dinle - listen to me - no hint
gibi gorunmek - look like - no hint
pazartesi - monday - no hint
arka - back - no hint
keşke - if only - no hint
göreceğiz - we39ll see - no hint
kartları - cards - no hint
kitabın - your book - no hint
kahretsin - damn - no hint
değişti - changed - no hint
işaret - mark - no hint
ilişki - relationship - no hint
rüyalar - dreams - no hint
saniye - second - no hint
delilik - madness - no hint
tehlikeli - dangerous - no hint
kardeşler - siblings - no hint
olurdu - it would be - no hint
onu görmek - see him - no hint
canı yanmak - hurts - no hint
yaptık - we did - no hint
londra - london - no hint
verme - don39t give - no hint
sebep olmak - to cause - no hint
çoğu - most - no hint
arka fon - background - no hint
geri geldim - i came back - no hint
yığın - stack - no hint
dokunuşlar - touches - no hint
komutan - commander - no hint
bana göre - according to me - no hint
misyon - mission - no hint
hayatları - their lives - no hint
ben yutarım - i swallow - no hint
katıldı - joined - no hint
ilgilenen - interested in - no hint
bina - bina - no hint
ipucu - hint - no hint
gençler - youth - no hint
majesteleri - your majesty - no hint
lee - lee - no hint
çiçekler - flowers - no hint
tema - theme - no hint
biliyor musun - do you know - no hint
kapatır - closes - no hint
denenmiş - tried - no hint
en sonunda - finally - no hint
hayvanlar - animals - no hint
beyefendi - gentleman - no hint
ihtiyaç - need - no hint
başlar - it starts - no hint
askerler - soldiers - no hint
anlar - understands - no hint
değer - value - no hint
mil - one thousand - no hint
sen olacaksın - you will be - no hint
akıllı - smart - no hint
olacaksın - you will be - no hint
saygı duyuyorum - i respect - no hint
ararlar - they seek - no hint
hakim - judge - no hint
ingilizce - the english - no hint
şekiller - shapes - no hint
sahibim - i have - no hint
bacaklar - legs - no hint
ver bana - give me - no hint
hanımlar - ladies - no hint
haydi - come on - no hint
sen taşı - you move - no hint
mart - march - no hint
ışıklar - the lights - no hint
sana yardım etmek - to help you - no hint
fark - difference - no hint
arayacağım - i will call - no hint
tanışmak - meet - no hint
yalnız bırakın - leave alone - no hint
ayrılacağım - i will leave - no hint
biz konuşuruz - we talk - no hint
yorgun - tired - no hint
çiftlik hayvanları - farm animals - no hint
görünüyorsun - you look - no hint
konuşulmuş - spoken - no hint
stil - style - no hint
bana yardım et - help me - no hint
seyretme - watch - no hint
uyanmak - wake up - no hint
sana vermek için - to give you - no hint
not - not - no hint
yapabilir misin - can you - no hint
mayıs - may - no hint
onlar vardı - they we're - no hint
yükselir - rises - no hint
uçuş - flight - no hint
olacağız - we will be - no hint
aptalca işler - stupid deeds - no hint
saygı - respect - no hint
dilekler - wishes - no hint
ol - be - no hint
meli - ship - no hint
bulduk - we found - no hint
öpücük - kiss - no hint
geri gitti - went back - no hint
kurallar - rules - no hint
bitiş - finish - no hint
unutulmuş - forgotten - no hint
o başladı - he started - no hint
atlar - the horses - no hint
huzurlu - peaceful - no hint
vd - vd - no hint
köpekler - dogs - no hint
evli - the married - no hint
vardım - i arrived - no hint
ilaçlar - medicines - no hint
diye sordu - she asked - no hint
tatiller - holidays - no hint
fincan - cup - no hint
soruşturma - investigation - no hint
tercih etmek - prefer - no hint
alışığım - i am used to - no hint
ben taşıyacağım - i will carry - no hint
sıklıkla - often - no hint
ziyaret etmek - visit - no hint
bomba - bomb - no hint
sırt çantası - backpack - no hint
seni yapmak - doing you - no hint
noel baba - santa claus - no hint
amerika birleşik devletleri - united states of america - no hint
metre - meter - no hint
çalma - stealing - no hint
kaçış - escape - no hint
hizmet ediyor - it serves - no hint
türler - species - no hint
silâh - weapon - no hint
yukarı git - go up - no hint
fe - fe - no hint
modlar - modes - no hint
filmler - movies - no hint
onunki - his - no hint
hemen - now - no hint
endişeler - worries - no hint
öğleden sonra - afternoon - no hint
kaçırdım - i missed - no hint
dönmek - return - no hint
vadesi dolmuş - expired - no hint
aniden - suddenly - no hint
charmed - charmed - no hint
mankafalı - mankafalı - no hint
bağlı olmak - adhere to - no hint
yaygın - common - no hint
bildiri - notification - no hint
öl - oil - no hint
saçma - absurd - no hint
giriş - login - no hint
buldu - found - no hint
bitirmek için - to finish - no hint
amerika - america - no hint
prens - prince - no hint
hazırlanmış - prepared - no hint
amaç - goal - no hint
dışarı çıktı - went out - no hint
müşteri - customer - no hint
mutlak - absolute - no hint
kim o - who is it - no hint
benziyorlar - they look like - no hint
aradım - i called - no hint
deneyin - try - no hint
kayın - beech - no hint
prenses - princess - no hint
takip ederim - i follow - no hint
unut bunu - forget this - no hint
fransa - france - no hint
hızlı bir şekilde - quickly - no hint
anahtarlar - keys - no hint
attı - threw - no hint
domuz - pig - no hint
ingiltere - britain - no hint
bakış - view - no hint
kaç - escape - no hint
savunma - defense - no hint
konuştum - i talked - no hint
onu yap - do it - no hint
hadi gidelim - let39s go - no hint
iç - internal - no hint
apartman - apartment - no hint
tiyatro - theater - no hint
beni yap - make me - no hint
papalar - popes - no hint
güven - confidence - no hint
şarkı söyle - sing a song - no hint
duyarsın - you hear - no hint
kuvvetler - forces - no hint
sarhoş - drunk - no hint
kahraman - hero - no hint
pelerin - cloak - no hint
diş - teeth - no hint
yavaşça - slowly - no hint
toplum - society - no hint
utanç - shame - no hint
sonbahar - autumn - no hint
yaralı - wounded - no hint
hesaplar - accounts - no hint
yıldızlar - the stars - no hint
kaçınmak - avoid - no hint
o olacak - it will - no hint
hafıza - memory - no hint
sinirli - angry - no hint
yazık - pity - no hint
çağ - age - no hint
satmak - sell - no hint
siyaset - politics - no hint
kalkmak - get up - no hint
ders çalışma - study - no hint
izin veriyor - they39re giving permission - no hint
adalet - justice - no hint
planlar - plans - no hint
bana bak - look at me - no hint
vardık - we arrived - no hint
roma - rome - no hint
papa - pope - no hint
muazzam - muazzam - no hint
masum - innocent - no hint
kendilerini - themselves - no hint
pantolon - trousers - no hint
bakan - minister - no hint
demek istediğim - i mean - no hint
isimler - names - no hint
komut - command - no hint
kaldı - stayed - no hint
tartmak - pull - no hint
hasta - patient - no hint
aşık - in love - no hint
otobüs - bus - no hint
hatırlatmak - remind - no hint
küçük olanlar - little ones - no hint
alınmış - taken - no hint
oturma - sitting - no hint
köprü - bridge - no hint
anlama - understanding - no hint
yumurtalar - eggs - no hint
alırım - i get - no hint
masal - tale - no hint
şişe - bottle - no hint
aceleyle - in a hurry - no hint
mutluluk - happiness - no hint
kılıç - sword - no hint
haberler - the news - no hint
evler - houses - no hint
katılıyor musun - do you join - no hint
tuzak - trap - no hint
buradayım - i am here - no hint
göstermek - show - no hint
yapabileceğim - i can do - no hint
piç - bastard - no hint
takip et - follow - no hint
gazete - newspaper - no hint
koni - horses - no hint
siyahlar - blacks - no hint
canavar - monster - no hint
hey - hey - no hint
hissettim - i felt - no hint
almalıyım - i have to take - no hint
oradaki - there - no hint
polisler - police officers - no hint
plaj - beach - no hint
kapılar - doors - no hint
oturma yeri - place of residence - no hint
restoran - restaurant - no hint
gerçekler - truths - no hint
hadi yapalım - let 39s do it - no hint
olağanüstü - exceptional - no hint
pzt - mon - no hint
girişim - attempt - no hint
taslak - draft - no hint
müşteriler - customers - no hint
isterdim - i would like to - no hint
operasyon - operation - no hint
görüntü - image - no hint
taşıdım - i carried - no hint
sevdiğiniz - you love - no hint
beğendi - like - no hint
çok fazla - too much - no hint
hisler - feelings - no hint
buna inan - believe it - no hint
onlar taşır - they carry - no hint
uykuda - asleep - no hint
hikayeler - stories - no hint
gördün - you saw - no hint
unutmak - forget - no hint
dinlemek - listen - no hint
hastalık - illness - no hint
parmaklar - fingers - no hint
olmuş - dead - no hint
diyorsun ki - you mean - no hint
cuma - only - no hint
endişeli - worried - no hint
dersler - lessons - no hint
ray - ray - no hint
faydasız - useless - no hint
sana sahip olmak - have you - no hint
amerikan - american - no hint
damak zevki - taste - no hint
ulusal - national - no hint
lanetli - damned - no hint
bıçak - knife - no hint
ibas - ibas - no hint
fransızca - french - no hint
ben kalıyorum - i stay - no hint
yapabileceğiz - we will be able to - no hint
gururlu - proud - no hint
hırsız - thief - no hint
sor - row - no hint
diye sordum - i asked - no hint
yapacaklar - they will do - no hint
askeri - military - no hint
takdir ediyorum - i appreciate - no hint
giydi - wore - no hint
sokaklar - streets - no hint
cen - cen - no hint
şahitlik - testimony - no hint
gideceksin - you will go - no hint
almanlar - the germans - no hint
dinlenmek - have a rest - no hint
roja - roja - no hint
tomalar - tomalar - no hint
sahip - owner - no hint
acil durum - emergency - no hint
toz - powder - no hint
melekler - angels - no hint
mesafe - distance - no hint
bravo - bravo - no hint
avrupa - europe - no hint
öldürdüler - they killed - no hint
lordluk - lordship - no hint
evlenmek - get married - no hint
zil sesleri - ringtones - no hint
melek - angel - no hint
dışarı çıkarır - pulls out - no hint
diyelimki - let39s say - no hint
beni ara - call me - no hint
yük - load - no hint
çalmak - play - no hint
bıraktın - you left - no hint
felaket - disaster - no hint
hamile - pregnant - no hint
yaşam - life - no hint
kapatmak - close - no hint
kağıtlar - papers - no hint
cesur - brave - no hint
ihtişam - magnificence - no hint
mükemmel bir şekilde - perfectly - no hint
umursamak - care about - no hint
yalvarırım - i beg - no hint
görünüyordu - seemed - no hint
bırak - leave - no hint
sıkışmış - jammed - no hint
gerisi - rest - no hint
yanlar - sides - no hint
olasılık - possibility - no hint
yetenek - ability - no hint
beni öldür - kill me - no hint
kodu - home - no hint
park - park - no hint
öldüreceğim - i will kill - no hint
çıkma - emergence - no hint
ateş etmek - fire - no hint
sorar - asks - no hint
sahip olmalı - should have - no hint
biter - ends - no hint
aynı zamanda - same time - no hint
barınak - shelter - no hint
bulursun - you find - no hint
verdiğiniz - you gave - no hint
seni tanıyorum - i know you - no hint
hayal ediyorum - i imagine - no hint
dahi - even - no hint
profesyonel - professional - no hint
koydum - i put - no hint
seçenek - option - no hint
mahkeme - court - no hint
etki - effect - no hint
basınç - pressure - no hint
çaldı - stole - no hint
cıkacak - will come out - no hint
belediye başkanı - mayor - no hint
tavuk - chicken - no hint
viski - whiskey - no hint
otoyol - motorway - no hint
cumartesi - saturday - no hint
havalimanı - airport - no hint
ilaç - medicine - no hint
bedava - free - no hint
düşer - falls off - no hint
kale - kale - no hint
kar - kar - no hint
ben ararım - i call - no hint
risk - risk - no hint
almanca - german - no hint
kirli - dirty - no hint
aptallar - fools - no hint
onlar buldular - they found - no hint
onlar düşünür - they think - no hint
nedenleri - reasons - no hint
pound - pound - no hint
hadi konuşalım - let39s talk - no hint
düşmanlar - enemies - no hint
marka - brand - no hint
önder - leader - no hint
onlar konuşur - they speak - no hint
uyuyor - sleeping - no hint
rahatlama - relaxation - no hint
futbol - football - no hint
detaylar - detail - no hint
yapardım - i used to do it - no hint
alınan - taken from - no hint
hazine - treasure - no hint
gömlek - shirt - no hint
yoldaşlar - comrades - no hint
taşınan - carried over - no hint
nakliye - shipping - no hint
hayalet - ghost - no hint
ait - belong to - no hint
sunuyorum - i present - no hint
biz taşıyoruz - we are carrying - no hint
kahvaltı - breakfast - no hint
hak ediyor - deserves - no hint
lárgate - lárgate - no hint
sen koy - you put - no hint
memurlar - officers - no hint
kurban - victim - no hint
semt - district - no hint
talihsiz - unfortunate - no hint
sorumluluk - responsibility - no hint
giriyorum - i39m entering - no hint
mücadele - struggle - no hint
fırtına - storm - no hint
duydun - you heard - no hint
koku - odor - no hint
miktar - quantity - no hint
muhteşem - spectacular - no hint
istediler - they wanted - no hint
güçsüz - powerless - no hint
laboratuar - lab - no hint
sigara içmek - to smoke - no hint
eğitimci - trainer - no hint
dinleme - listening - no hint
korkmuş - scared - no hint
davet edildi - invited - no hint
geldin mi - did you come - no hint
jüri - jüri - no hint
almanya - germany - no hint
pastel - pastel - no hint
direkt olarak - directly - no hint
sosyo - socio - no hint
çalıntı - stolen - no hint
açıklamak - explain - no hint
oyunlar - games - no hint
önem - importance - no hint
haklar - rights - no hint
model - model - no hint
gidiyordu - was going - no hint
dostum - my friend - no hint
açıkça - clearly - no hint
alacağım - i will take - no hint
ağaçlar - trees - no hint
tavan - ceiling - no hint
beyazlar - whites - no hint
bana sahip - have me - no hint
tomo - tomo - no hint
şampiyon - champion - no hint
son zamanlarda - recently - no hint
ilişkiler - relationships - no hint
sahne - scene - no hint
ödlek - coward - no hint
düşme - fall - no hint
kullanma - use - no hint
garanti ederim - i guarantee - no hint
gördüler - they saw - no hint
kalacak - will stay - no hint
güven bana - trust me - no hint
sırlar - secrets - no hint
göğüs - chest - no hint
yalanlar - lies - no hint
duygu - emotion - no hint
kör - drive - no hint
fabrika - factory - no hint
anlatacağım - i will tell - no hint
eh aslında ben bunu pek iyi bilmiyorum - uh actually i don't know this very well - no hint
araba sahibi değilsin - don't have a car - no hint
anne ve baban için - for your mother and father - no hint
bu ve şu lütfen - this and that please - no hint
o - he - no hint
görünmek - seem - no hint
yıl - year - no hint
ya - really - no hint
o1 - he - no hint
o2 - he - no hint
o3 - he - no hint
o4 - he - no hint
o5 - he - no hint
o6 - he - no hint
o7 - he - no hint
o8 - he - no hint
o9 - he - no hint
yıl1 - year - no hint
nazar değmesin - touch wood - no hint
söylemedim - i didn't say - no hint
şimdi hızlıca duş almam gerekiyor - now i need to take a quick shower - no hint
olan - the one - no hint
oluşturmak - create - no hint
ödü patlamak - too scared - no hint
onu anlayan - who understands it - no hint
ödül - prize - no hint
ödüm patladı - i'm too scared - no hint
önemli - important - no hint
önemli1 - important - no hint
önemli2 - important - no hint
önemli3 - important - no hint
olsa - though - no hint
uyku - sleep - no hint
uyku1 - sleep - no hint
uyku2 - sleep - no hint
nazik - kind - no hint
duş - shower - no hint
duş1 - shower - no hint
duş2 - shower - no hint
bunu ödemeden gidemeyiz - we can't go without paying this - no hint
uçak - airplane - no hint
uçak1 - airplane - no hint
uçak2 - airplane - no hint
uzak - far - no hint
uzak1 - far - no hint
uğraşmak - to deal struggle - no hint
ortaçağa ait - medieval - no hint
erken - early - no hint
ben uyanığım - i am awake - no hint
oyuncu - player actor - no hint
oyuncu1 - player actor - no hint
oyuncu2 - player actor - no hint
oyuncu3 - player actor - no hint
oyuncu4 - player actor - no hint
padişah öyle eyledi - the sultan has commanded so - no hint
pahalı - expensive - no hint
pahalı1 - expensive - no hint
ağrılı - sore - no hint
tuz - salt - no hint
tuz1 - salt - no hint
tuz2 - salt - no hint
tuz3 - salt - no hint
nerelisin - where are you from - no hint
nerelisin1 - where are you from - no hint
o zordu ama biz başardık - it was hard but we made it - no hint
acımasız olmak bir tercihtir - to be cruel is a choice - no hint
ben gitar çalıyorum - i play guitar - no hint
lütfen öğleden önce gel - please come before noon - no hint
internette - on the internet - no hint
televizyon - television - no hint
taksi - taxi - no hint
tren - train - no hint
televizyon1 - television - no hint
televizyon2 - television - no hint
televizyon3 - television - no hint
tren1 - train - no hint
tren2 - train - no hint
fotoğrafın - your photograph - no hint
şeker - candy - no hint
şeker1 - candy - no hint
programcı - programmer - no hint
zamir - pronoun - no hint
zamir1 - pronoun - no hint
dışında - outside except for - no hint
ya - really well ohh - no hint
rusçayı - russian - no hint
satis elemani - salesman - no hint
bazı - some - no hint
bazı1 - some - no hint
konuşmamı - my speech - no hint
çoğunu - most of - no hint
sevimli - cute - no hint
sevimli1 - cute - no hint
susamış - thirsty - no hint
sanatçı - performer - no hint
sanatçı1 - performer - no hint
sanatçı2 - performer - no hint
sanatçı3 - performer - no hint
sanatçı4 - performer - no hint
sanatçı5 - performer - no hint
sermaye - capital - no hint
sermaye1 - capital - no hint
amerıkada çok yıldır lakin bundan önce scotland daben - in america for many years but before that in scotland - no hint
sayısız - countless - no hint
kız - girl - no hint
kız1 - girl - no hint
kız2 - girl - no hint
ayakkabı - shoe - no hint
ayakkabı1 - shoe - no hint
ayakkabı2 - shoe - no hint
generelikle - usually - no hint
sıcacık - warm - no hint
çalışan - working - no hint
yiyecek - food - no hint
söz - statement - no hint
anahtar - key - no hint
anahtar1 - key - no hint
anahtar2 - key - no hint
tabak - tobacco - no hint
tabak1 - tobacco - no hint
çanta - bag - no hint
çanta1 - bag - no hint
çanta2 - bag - no hint
fakir - poor - no hint
yanlıs - false - no hint
yanlıs1 - false - no hint
pes etme - do not give up - no hint
yanlış - wrong - no hint
yanlış1 - wrong - no hint
yönetici - manager - no hint
yorgun - tired - no hint
yorgun1 - tired - no hint
rahatlatıcı - relaxing - no hint
psikolojik - psychological - no hint
şimdi hapı yuttum - i'm in trouble now - no hint
sanayi - industry - no hint
sessiz - quiet - no hint
sessiz1 - quiet - no hint
çalışmak - work - no hint
nbsp - soundgun_enmp3 - no hint
tek - single - no hint
temiz - clean - no hint
on - on - no hint
on1 - ten - no hint
on2 - ten - no hint
on3 - ten - no hint
on4 - ten - no hint
on5 - ten - no hint
tavsiye - advice - no hint
tavsiye1 - advice - no hint
çünkü gözlerim bozuk - because my eyes are bad - no hint
çamaşır - laundry - no hint
şunu açıklamadan hiçbir yere gidemez - he can't go anywhere without explaining that - no hint
kullanmak - use - no hint
koyun etini mundar etmeden hazırlayın - prepare the mutton without rendering it useless - no hint
kuzu eti - lamb meat - no hint
buçuk - half - no hint
bulunuyor - is located - no hint
bedava - free - no hint
bedava1 - free - no hint
boşver - nevermind - no hint
araba - car - no hint
araba1 - car - no hint
araba2 - car - no hint
araba3 - car - no hint
araba4 - car - no hint
araba5 - car - no hint
araba6 - car - no hint
araba7 - car - no hint
tavuk - chicken - no hint
tavuk1 - chicken - no hint
müşteri ofise geliyor - the client is coming to the office - no hint
komik - funny - no hint
komik1 - funny - no hint
bilgisayar - computer - no hint
bilgisayar1 - computer - no hint
bilgisayar2 - computer - no hint
bilgisayar3 - computer - no hint
bilgisayar4 - computer - no hint
bilgisayar5 - computer - no hint
bilgisayar6 - computer - no hint
bilgisayar7 - computer - no hint
bilgisayar8 - computer - no hint
bilgisayar9 - computer - no hint
aşçı - chef - no hint
aşçı1 - chef - no hint
aşçı2 - chef - no hint
küçük - small - no hint
küçük1 - small - no hint
küçük2 - small - no hint
hala - still - no hint
hala1 - still - no hint
hala2 - still - no hint
hala3 - still - no hint
hala4 - still - no hint
hala5 - still - no hint
hala6 - still - no hint
hala7 - still - no hint
hala8 - still - no hint
hala9 - still - no hint
kurmak - to install - no hint
binlerce yıldır insan evrimi devam eder - human evolution continues on for thousands of years - no hint
söyleyemedim - i couldn't say - no hint
imparator - emperor - no hint
fincan - cup - no hint
fincan1 - cup - no hint
balık - the fish - no hint
balık1 - the fish - no hint
balık2 - the fish - no hint
balık3 - the fish - no hint
balık4 - the fish - no hint
balık5 - the fish - no hint
balık6 - the fish - no hint
giysi - clothes - no hint
zayıf - weak - no hint
vay - wow - no hint
göğüs - chest - no hint
göğüs1 - chest - no hint
göğüs2 - chest - no hint
güneş - sun - no hint
güneş1 - sun - no hint
güneş2 - sun - no hint
güneş3 - sun - no hint
güneş4 - sun - no hint
güneş5 - sun - no hint
güneş6 - sun - no hint
güzel - beautiful - no hint
güzel1 - beautiful - no hint
güzel2 - beautiful - no hint
güzel3 - beautiful - no hint
güzel4 - beautiful - no hint
güzel5 - beautiful - no hint
güzel6 - beautiful - no hint
güzel7 - beautiful - no hint
güzel8 - beautiful - no hint
güzel9 - beautiful - no hint
hayat dolu - lively - no hint
endüstri - industry - no hint
endüstri1 - industry - no hint
dakika - minute - no hint
dakika1 - minute - no hint
öncülük etmek - lead - no hint
üzgün - sad - no hint
üzgün1 - sad - no hint
üzgün2 - sad - no hint
hatırmak - to remember - no hint
hatır - sake respect - no hint
hatırlamak - to remember - no hint
hatırlamak1 - to remember - no hint
zaten - already - no hint
dar - but - no hint
sonrakini - the next - no hint
hemşire - nurse - no hint
hemşire1 - nurse - no hint
hemşire2 - nurse - no hint
pantolon - trousers - no hint
pantolon1 - trousers - no hint
pantolon2 - trousers - no hint
parfüm - perfume - no hint
parlak - bright - no hint
rüzgarlı - windy - no hint
rüzgarlı1 - windy - no hint
rüzgarlı2 - windy - no hint
başkan - president - no hint
başkan1 - president - no hint
başkan2 - president - no hint
temizlemek - to clean - no hint
temizlemek1 - to clean - no hint
bira - beer - no hint
bira1 - beer - no hint
bira2 - beer - no hint
bira3 - beer - no hint
mağaza - shop - no hint
sınavında - on the exam - no hint
mağaza - shop - no hint
kredi kartı - credit card - no hint
öğretmen - teacher - no hint
öğretmen1 - teacher - no hint
öğretmen2 - teacher - no hint
öğretmen3 - teacher - no hint
öğretmen4 - teacher - no hint
tatlı - dessert - no hint
tatlı1 - dessert - no hint
tüm - all - no hint
tüm1 - all - no hint
aç - hungry - no hint
aç1 - hungry - no hint
aç2 - hungry - no hint
aç3 - hungry - no hint
aç4 - hungry - no hint
aç5 - hungry - no hint
eh aslında - um actually - no hint
yön - way - no hint
yön1 - way - no hint
yaklaşık - about - no hint
asya yakası - asian side - no hint
bir battaniye alabilir miyim - may i have a blanket - no hint
kanepe - couch - no hint
kanepe1 - couch - no hint
çocuk - child - no hint
çocuk1 - child - no hint
çocuk2 - child - no hint
çocuk3 - child - no hint
çocuk4 - child - no hint
çocuk5 - child - no hint
çocuk6 - child - no hint
anlaşma - contract - no hint
fark - difference - no hint
kitap - book - no hint
kitap1 - book - no hint
kitap2 - book - no hint
kitap3 - book - no hint
kitap4 - book - no hint
kitap5 - book - no hint
kitap6 - book - no hint
kitap7 - book - no hint
ihtiyacım - i need - no hint
eski - old things - no hint
eski1 - old things - no hint
eski2 - old things - no hint
yüksek - high - no hint
nemli - damp - no hint
bu alan tehlikeli - this area is dangerous - no hint
öğrencinin görevi ödevi yapmak - a student's duty is to do homework - no hint
zorunda - i have to - no hint
ben bu hafta meşgulüm - busy this week - no hint
arasındaki - between - no hint
değer - value - no hint
değer1 - value - no hint
değer2 - value - no hint
onlar geri gelmezse yanarız - we're in trouble if they don't return - no hint
sakin - mine - no hint
sakin1 - mine - no hint
sakin2 - mine - no hint
düşük - low - no hint
yabancı - foreign - no hint
yabancı1 - foreign - no hint
onlar gittiyse - if they're gone - no hint
bugün - today - no hint
bugün1 - today - no hint
bugün2 - today - no hint
formül - formula - no hint
vurmak - hit - no hint
karşılaştırma - comparison - no hint
zengin - rich - no hint
teknisyen - technician - no hint
olmak - be - no hint
olmak1 - be - no hint
olmak2 - be - no hint
olmak3 - be - no hint
verimli - productive - no hint
 - soundto get a message mp3 - no hint
yarına yemek - dinner for tomorrow - no hint
yarın gelmesi mümkün - she might come tomorrow - no hint
kasaba - town - no hint
bizim adetlerimiz - our traditions - no hint
bırak - leave - no hint
motosiklet - motorcycle - no hint
ceket - jacket - no hint
helikopter - helicopter - no hint
doktor - doctor - no hint
otel - hotel - no hint
ceket1 - jacket - no hint
helikopter1 - helicopter - no hint
doktor1 - doctor - no hint
doktor2 - doctor - no hint
doktor3 - doctor - no hint
doktor4 - doctor - no hint
doktor5 - doctor - no hint
otel1 - hotel - no hint
otel2 - hotel - no hint
istemek - request - no hint
yanmak - burn - no hint
an - moment - no hint
an1 - moment - no hint
an2 - moment - no hint
anda - in the moment - no hint
biz kaçarken siz neredeydiniz - where were you when we were running away - no hint
atmosfer - atmosphere - no hint
atmosfer1 - atmosphere - no hint
canlı - alive - no hint
canlı1 - alive - no hint
eğlenceli - fun - no hint
ne zaman döner - what time does he return - no hint
duymak - hear - no hint
uf gene kaçtı - it escaped again - no hint
o ağlamakta iyidir bence - she is good at crying i think - no hint
havalı - cool or swanky - no hint
koşuta - running - no hint
okyanusun yakınında - by the ocean - no hint
izin - permission - no hint
tek - alone - no hint
yetişkin - adult - no hint
yetişkin1 - adult - no hint
emin - sure - no hint
emin1 - sure - no hint
emin2 - sure - no hint
acel - in a hurry - no hint
yoğun - dense - no hint
girmek - to enter - no hint
açıklamak - explain - no hint
açıklamak1 - explain - no hint
to motivate - to motivate - no hint
kavurmak - roast - no hint
oğlan - boy - no hint
bluz - blouse - no hint
bluz1 - blouse - no hint
doğru - right - no hint
doğru1 - right - no hint
doğru - right - no hint
doğru1 - right - no hint
biz kaçarken - when we were running away - no hint
kimin umrunda - who cares - no hint
algılamak - detect sense - no hint
algılamak1 - detect sense - no hint
şansim - my chance - no hint
imkansız1 - impossible - no hint
yer - ground - no hint
yer1 - ground - no hint
yer2 - ground - no hint
yakalamak - to catch - no hint
yaygın ifade - common expression - no hint
yağmur - rain - no hint
yağmur1 - rain - no hint
yağmur2 - rain - no hint
yağmur3 - rain - no hint
yağmur4 - rain - no hint
yağmurlu - rainy - no hint
yeni - new - no hint
yani - so - no hint
yani1 - so - no hint
yani2 - so - no hint
yani3 - so - no hint
yanıt - response - no hint
yanıt1 - response - no hint
yanıt2 - response - no hint
yatak - bed - no hint
yeter - enough - no hint
yetenek - talent - no hint
yapmalısın - you should - no hint
yeşillik - greens weed - no hint
o dünyadaki en güzel şehir - it's the most beautiful city in the world - no hint
gece yarısı - midnight - no hint
sıkıcı - boring - no hint
sıkıcı1 - boring - no hint
haklısın - you are correct - no hint
çok haklısın konuşmak öğrenmenin en iyi yolu - you are very correct speaking is the best way to learn - no hint
heyecanlı - excited - no hint
uyuyorsun - you are sleeping - no hint
heyecanlıyım - im excited - no hint
bitmek - to finish - no hint
mutlu - happy - no hint
mutlu1 - happy - no hint
heyecan verici - exciting - no hint
seçin - select - no hint
sık sık - often - no hint
bitirdin mi - have you finished - no hint
tok - took - no hint
o çok şaşırdı - he was so surprised - no hint
seyahat - travel - no hint
öyle böyle - like that - no hint
sormak - ask - no hint
sormak1 - ask - no hint
naber - what's up - no hint
naber1 - what's up - no hint
naber2 - what's up - no hint
naber3 - what's up - no hint
naber4 - what's up - no hint
naber5 - what's up - no hint
naber6 - what's up - no hint
başka - another - no hint
başka1 - another - no hint
başka2 - another - no hint
başka3 - another - no hint
baş ağrım var - i have a headache - no hint
bebek - baby - no hint
bebek1 - baby - no hint
bebek2 - baby - no hint
bebek3 - baby - no hint
bebek4 - baby - no hint
bebek5 - baby - no hint
almak - receive - no hint
almak1 - receive - no hint
almak2 - receive - no hint
çağırmak - call - no hint
sizi sonra tekrar arayabilir mi - can he call you again later - no hint
tadını - taste - no hint
yaş - age - no hint
yaş1 - age - no hint
çirkin - ugly - no hint
gelmek - come - no hint
gelmek1 - come - no hint
gelmek2 - come - no hint
gelmek3 - come - no hint
iltifat - compliment - no hint
utanmiş - ashamed - no hint
kirli - dirty - no hint
kâğıt - paper - no hint
tartışmak - debate - no hint
hak etmek - deserve - no hint
kar - snow - no hint
kar1 - snow - no hint
kar2 - snow - no hint
kar3 - snow - no hint
kar4 - snow - no hint
kar5 - snow - no hint
izlemek - to watch - no hint
içeri gel - come in - no hint
acı - pain - no hint
acı1 - pain - no hint
acı2 - pain - no hint
acı3 - pain - no hint
zevk olmak tadını çıkarmak eğlenmek - to enjoy - no hint
suçlu - guilty - no hint
bulmak - find - no hint
gizemli - mysterious - no hint
fiş - plug - no hint
bilgi - information - no hint
bilgi1 - information - no hint
bilgi2 - information - no hint
gitmek - go - no hint
gitmek1 - go - no hint
haziranda bir haftalık tatil talep etmek istiyorum - i want to request a oneweek vacation in june - no hint
vadeli - term - no hint
hafta - week - no hint
hafta1 - week - no hint
ne kötü bir hava - what bad weather - no hint
dikkatli - careful - no hint
saniye - second - no hint
hissetmek - to feel - no hint
sert - hard - no hint
satmak - sell - no hint
kısa - short - no hint
kısa1 - short - no hint
niyet - intention - no hint
şey - thing - no hint
şey1 - thing - no hint
kızın - your daughter - no hint
bırakmak - to leave - no hint
bırakmak1 - to leave - no hint
bırakmak2 - to leave - no hint
izin vermek - to let - no hint
gömlek - shirt - no hint
gömlek1 - shirt - no hint
gömlek2 - shirt - no hint
gömlek3 - shirt - no hint
gömlek4 - shirt - no hint
bakmak - look - no hint
bakmak1 - look - no hint
lakin bundan - but from that but before that - no hint
karar - decision - no hint
ummak - to hope - no hint
hafıf - hafıf - no hint
to plan - to plan - no hint
koydum - i put - no hint
şampuanlamak - to shampoo - no hint
şampuanlamak1 - to shampoo - no hint
şampuanlamak2 - to shampoo - no hint
çocuklar hemen arkadaş olur - kids become friends quickly - no hint
iğrenç - disgusting - no hint
iğrenç1 - disgusting - no hint
iğrenç2 - disgusting - no hint
koyu - dark - no hint
koyu1 - dark - no hint
saat - moment - no hint
saat1 - hour - no hint
saat3 - hour - no hint
saat - moment - no hint
saat1 - moment - no hint
hayal - dream - no hint
hayal1 - dream - no hint
hayal2 - dream - no hint
memnuniyetsiz - dissatisfied - no hint
söylemek - say - no hint
denemek - try - no hint
sahip olmak - have - no hint
sıcak - hot - no hint
sıcak1 - hot - no hint
sıcak2 - hot - no hint
atmak - throw away send - no hint
atmak1 - throw away send - no hint
şarap - wine - no hint
şarap1 - wine - no hint
şarap2 - wine - no hint
kazası - accident - no hint
tekne - boat - no hint
şovda - in the show - no hint
gezdirmek - to show around - no hint
göstermek - show - no hint
göstermek1 - show - no hint
sıfat - adjective - no hint
sıfat1 - adjective - no hint
lütfen burayı imzalayın - please sign here - no hint
üstte - on top - no hint
su - water - no hint
su1 - water - no hint
su2 - water - no hint
su3 - water - no hint
su4 - water - no hint
su5 - water - no hint
su6 - water - no hint
su7 - water - no hint
su8 - water - no hint
su9 - water - no hint
önermek - suggest - no hint
almak - receive - no hint
almak1 - receive - no hint
almak2 - receive - no hint
uzun hikaye - it's a long story - no hint
uzun hikaye1 - it's a long story - no hint
anlatmak - tell - no hint
anlatmak1 - tell - no hint
arkadaş - friend - no hint
arkadaş1 - friend - no hint
düşünmek - think - no hint
çim - grass - no hint
yürümek - to walk - no hint
ne zaman açılıyor - when does it open - no hint
hangi diziyi izliyordun - which series were you watching - no hint
sırt - back - no hint
çalışmak - work - no hint
ritim - rhythm - no hint
uzun - long - no hint
yıl - year - no hint
yıl1 - year - no hint
yarın - tomorrow - no hint
yarın1 - tomorrow - no hint
yarın2 - tomorrow - no hint
yarın3 - tomorrow - no hint
yarın4 - tomorrow - no hint
yarın5 - tomorrow - no hint
yarın6 - tomorrow - no hint
yarın7 - tomorrow - no hint
yarın8 - tomorrow - no hint
belediye - municipality - no hint
senin kadar iyi - as good as you - no hint
kız - girl - no hint
kız1 - girl - no hint
kız2 - girl - no hint
kazanmak - win - no hint
kazanmak1 - win - no hint
baba1 - father - no hint
baba2 - father - no hint
baba3 - father - no hint
baba4 - father - no hint
baba5 - father - no hint
ayak - foot - no hint
ayak1 - foot - no hint
ayak2 - foot - no hint
ayak3 - foot - no hint
takvim - calendar - no hint
yüreğimin bir parçası - a piece of my heart - no hint
en iyi dileklerimle - best wishes - no hint
zor - hard - no hint
zor1 - hard - no hint
