çünkü bulaşık deterjanı almaya giderken telefonumdan arnavutça dersi dinliyorum ve yirmiiki dakikası kaldı - because i'm listening to an albanian lesson on my phone on the way to buy dish soap and i have twentytwo minutes left
alışkanlığımı kaybettim - i lost my habit
zihin açıklığı - clarity of mind
kırılmam - i won't break
belgesel - documentary
amuda kalkıyorum - doing a handstand
dik - steep
bu normalin tersi - this is the opposite of normal
maceralarla dolu rüyalar görürsün inşallah - i hope you have dreams full of adventures
şu anda baş aşağıyım - i'm upside down right now
ahşap tahtalar - wooden boards
umarım nereden aldığımı hatırlarım - i hope i remember where i got it
ışık anahtarları - light switches
omega üç arıyorum - looking for omega three
her zamankinden daha değişikti - it was different than usual
balkabağı - pumpkin
banyo yapmaya ihtiyacım vardı - i had to go to the bathroom
bezelye - peas
bilerek - on purpose
değişikti - it was different
benim için sıkıntı değil - no problem for me
göz önünde bulundurulduğunda - taking into account
bahane - excuse
kedi köpekten korkar - cat afraid of dog
bana bir kaşık getirir misin lütfen - can you bring me a spoon please
derinlerine - deep into
not defteri - notebook
düzelttiklerin için teşekkür ederim - thank you for correcting
dondurucu açık - freezer open
keskin bir bıçak var mı - do you have a sharp knife
dört gözle bekliyorum - i'm looking forward to it
fakat - but
türkiyenin geri kalanı - rest of turkey
su geçirmez - waterproof
bir kase alıyorum - i'm taking a bowl
havlular - towels
çöpü alıp havluları değiştirdi - took the trash and changed the towels
otelin havuzunu kullanacağım - i will use the hotel pool
arka arkaya iki gün - two days in a row
buranın kuzeyinde - north of here
aşağı yukarı - more or less
bağımlıyım - i'm addicted
yani en azından bunu yapmalıyım - so at least i should do this
eğer kendimi yazmaya zorlarsam - if i force myself to write
mıknatıslı dolap - magnetic cabinet
böylelikle büyük bir daire oluşturdum - so i made a big circle
aslında yazıyor olmam gerekir - i should actually be typing
uyandığımda - when i wake up
ulusal - national
ama önümüzdeki haftanın sıcak olacakmış - but next week will be hot
öğrendiklerimden - from what i learned
basınç uyguluyorlar - they apply pressure
patlıcan - aubergine
buna dayanabilirim - i can stand it
rastgele dolaşırım - i wander randomly
mektebe - to school
sivrisinek - mosquito
iki şekilde yazacağım - i will write it in two ways
dikkatimi dağıtacak - will distract me
sarımsak - garlic
havlular buraya asılabilir - towels can be hung here
yakında yemek yapacak mısın - will you cook soon
temizlikçi - cleaner
tadı çok güzeldi - the taste was very good
dağ tarafına doğru koştum - i ran towards the mountain side
bunlar sayesinde daha fazla kart yapacağım - thanks to these i will make more cards
duşumun küveti yok - my shower doesn't have a tub
reyhan - basil
sen türkçe bellemişsen - if you remember turkish
basınç - pressure
karo zemin - tile floor
gözüme su kaçırmazlar - they don't get water in my eyes
çevresinde - around
çamaşır makinesi - washing machine
ellerimi kurutuyorum - i'm drying my hands
onun bu kutuya ne peynir ne şeker koymasına izin ver - let him put neither cheese nor sugar in this box
doğudaki dağlara doğru koştum - i ran towards the mountains in the east
günün aydın olsun - have a bright day
banyo aynasının arkasında işiklar var - there are lights behind the bathroom mirror
fikrimi değiştireceğim - i will change my mind
yüzme ile ilgili videolar - videos about swimming
panjurlar - shutters
sana keyifli zamanlar diliyorum - i wish you a pleasant time
gitmem lazım - i have to go
iniyordu - was descending
sunum - presentation
oldukça rahatlar - they are quite comfortable
rahatlat - relax
yolculuğum güzeldi - my journey was good
tasarlanmış - designed
dünya rekoru - world record
yokuşlu - hilly
çamaşır makinesinin uzatma kablosuna ihtiyacı var - washing machine needs extension cord
bir tencere getirir misin - can you bring a pot
yazmam gerektiğini hatırladım - i remembered that i had to write
birkaç inek gördüm - i saw a few cows
ilk defa soya küpleri aldım - i bought soy cubes for the first time
bir sinek - a fly
su koyda ıslansınlar - soak them in the water
hangi bölümden başlayacaksın - which part will you start from
iki kere yemek pişirdim - i cooked twice
bu sefer - this time
karadağ'a geldiğimden beri - since i came to montenegro
temizlik malzemeleri bu dolapta - cleaning supplies are in this cupboard
nereye gideceğimi bilmiyorum - i don't know where to go
oruç tutmadığımda - when i'm not fasting
valla iyisin - well you are fine
biz de dün ebrarı kırıkkaleye götürdük - we took ebrar to kırıkkale yesterday
hatırladığıma bakacağım - i will see what i remember
düz ekran televizyon - flat screen television
vardığımda - when i arrive
bu uzuyor - this is getting longer
hava biraz soğumaya başladı - the weather is getting a little cold
neredeyse hiç - hardly ever
neredeyse oradayım - i'm almost there
buzdolabı kapalı - refrigerator closed
kiminle konuştuğumu bilmiyorum - i don't know who i'm talking to
iyi yaşa - bless you
şimdi bulaşık yıkamaya gidiyordum - i was going to wash dishes now
etrafta dolaştım - i walked around
burnuma biraz basınç - a little pressure on my nose
onun gelişimini izlemek zevkli - it's fun to watch her progress
kalın perde - drape
nehire gittikten sonra markete gittim - i went to the market after i went to the river
sahile yakınım - i am near the beach
kendime zaman ayırdım - i took time for myself
ben üşüyorum - i'm cold
brüksel lahanası - brussels sprouts
birincisi tercümesiz ikincisi tercümeli - the first is without translation the second is with translation
taşlı - rocky
bana yazdıklarını at - throw me what you wrote
yorumunu sabırsızlıkla bekliyorum - i'm looking forward to your comment
yolun yarısındayım - i'm half way
boşnak böreği meşhur - bosnian pastry is famous
yürümeye gidiyorum - i'm going to walk
kızartma tavası var mı - do you have a frying pan
yarış - race
işini düzelttikten - after you fix your job
ayrıca - also
neyse - anyway
yatağa gitmeden - before going to bed
nefes tutma egzersizi - breath holding exercise
hücreler - cells
önce kötü hücreleri yer - eats bad cells first
oruç tutmadığım da - even though i'm not fasting
her şey düşünüldu - everything has been considered
oruç tutma - fasting
dilbilgisi - grammar
dil bilgisini - grammar
kadar yaygın olduğunu - how common it is
basit cümleler kurabiliyorum - i can form simple sentences
yazmadım - i did not write
yiyip içmedim - i didn't eat or drink
nasıl kuracağımı bilmiyorum - i don't know how to set it up
nefesimi tuttum - i held my breath
kiraladım - i rented
hatice'nin ailesiyle konuştum - i talked to hatice's family
sanırım oruç hakkında daha fazla konuşacağım - i think i'll talk more about fasting
ona yorgun olduğumu söyledim - i told him i was tired
yazmaya devam edeceğim - i will continue to write
onunla konuşuyorum - i'm talking to him
üç saat oldu - it's been three hours
son cümle - last sentence
hafıza - memory
zihin - mind
dil bilgim zayıf - my language skills are poor
günlük - journal
şekilde - way
yazacağım - i will write
birincisi - first
bir günlük başlatmak istiyorum - i want to start a diary
şu anda yunanistan atina'dayım - i am currently in athens greece
dün bir bisiklet aldım - i bought a bike yesterday
planım kuzeye gitmek - my plan is to go north
arnavutluk'u görmek istiyorum - i want to see albania
sanırım arkadaşlarım savage ve chelsea almanya'da olacak ve onları görmek istiyorum - i think my friends savage and chelsea will be in germany and i want to see them
herkese merhaba - hello everyone
bu benim günlüğüm ve şimdi günüm hakkında yazacağım - this is my diary and now i will write about my day
bu sabah bir kafede kahve içtim - i had coffee in a cafe this morning
soğuk ve lezzetliydi - it was cold and delicious
onu sevdim - i liked it
oraya bisikletimle gittim - i went there on my bike
oraya gitmeden önce rastgele dolaşırım ve kafenin nerede olduğunu bilmiyorum - before i went there i wandered around randomly and i don't know where the cafe is
şimdi bunu bilgisayarımda yazıyorum ve biraz önce hatice ile konuştum - now i'm typing this on my computer and i just spoke to hatice
daha sonra bu cümleleri translate ile kontrol edeceğim - later i will check these sentences with translate
üçüncü gün - day three
bugün yazamayacağımı düşünmüştüm ama bak işte buradayız - i thought i might not write today but look here we are
ben tembel değilim - i am not lazy
ancak belki bu sadece kısa bir giriş olacaktır - however maybe this will just be a short entry
az da olsa birşeyler yazmak hiç yazmamakdan iyidir - i think a short entry is better than no entry
bugün erken saatlerde bisikletimi sürdüm - earlier today i rode my bike
diğer günlere göre biraz daha fazla sürdüm - i didn't ride a lot but i rode more than every other day
bitirdim - i'm finished
kısa ve güzel - short and sweet
bana mesaj attı - he texted me
kulağa iyi geliyor - sounds good
karasız - unstable
kendine iyi bak - take care
bu benim planımdı - this was my plan
nasıl sorarsın - how do you ask
ders çalışırım ya da plaja giderim - i study or go to the beach
ders çalışacağım ya da plaja gideceğim - i will study or go to the beach
kolay gelsin - good luck with
allah zihin açıklığı versin - god give you clarity
iyi çalışmalar - good work
o zaman - in that case
oruspu çocuğu - son of a bitch
belgesel - documentary
telefonumdan - from my phone
giderken - on the go
iradeyi güçlendirdiği - strengthens the will
mantar - mushrooms
hokkabazlık yaptım - i juggled
coğrafya - geography
uçmak - fly
diğer günlere göre - compared to other days
biraz daha fazla - a little bit more
yazamayacağımı düşünmüştüm - i thought i couldn't write
bak işte buradayız - look here we are
arnavutluku görmek - see albania
bu cümleler - these sentences
kontrol edeceğim - i will check it
güzel bir gün geçirdim - i had a nice day
bunun hakkında konuşmak istiyorum - i want to talk about it
öğle yemeği için - for lunch
akşam yemeği için - for dinner
ikisi de lezzetliydi - both we're delicious
iki kere yüzdüm - i swam twice
bir tane sivrisinek - one mosquito
ingilizce yazacaktım - i was going to write in english
bu sefer önce ingilizce yazacaktım unuttum - i forgot i was going to write in english first this time
almaya giderken - on the way to get
arnavutça dersi dinliyorum - i'm listening to the albanian lesson
yirmiiki dakikası kaldı - twentytwo minutes left
düzeltmeler - fixes corrections
bütün gün - all day
kedi yerine köpeği al - get the dog instead of the cat
zorlaştırmamak - not to complicate
kolaylaştırdım - i made it easy
önceki - previous
önceki cümleyi - previous sentence
uzun sürdü - took a long time
çekmek - to pull
yaklaşık yedi - about seven
gitmesine izin verdiler - they let him go
eve geldikten sonra - after coming home
mağazaya gittim - i went to the store
tekrar eve geldim - i came home again
biraz zaman alacak - it will take some time
durmalıyım - i have to stop
birkaç gündür günlük yazmadım - i haven't written a diary for a few days
yolculuk - trip
ilk yarı - first half
engebeli - rugged
gittiğimde - when i go
muhtemelen - probably
kuzey - north
olabilir - it could be
bunu kısa tutacağım - i will keep this short
çevirdikten sonra - after turning
sonrasında - after that
hazırladım - i prepared
yemek yerken - while eating
zaman alacak - it will take time
ankara başkenttir - ankara is the capital
bir gölün yanındayım - i'm next to a lake
sandalet - sandals
oldukça aktifi - very active
deniz gözlüğü - goggles
dört gözle - look forward
burnuma - to my nose
yolun yarışı - race of the road
bir haftada - in a week
bu yüzden kim bilir - so who knows
bu yüzden - therefore
çeviri yaptıktan sonra - after translating
daha çok yazacağım - i will write more
aktif - active
açık hava - open air
spor salonu - gym
bisikletime bindim - i got on my bike
yaklaşık bir buçuk saat - about an hour and a half
şehirde dolaştım - i walked around the city
yüzme gözlükleri - swimming goggles
onları denedim - i tried them
tutarlar - amounts
ağrılı - sore
adında - named
yunanistan - greece
dikkatim - my attention
ne yapacağımı - what to do
oradayken - while you are there
isteyeceğim - i will want
alamayabilirim - i may not receive
altın - gold
metod - metod
sıfat - adjective
unuttuğum kelimeleri - words i forgot
efenim - sir
bana yazılar ver - give me texts
eksik bir kelime var - there is a missing word
gitmeye hazırım - i'm ready to go
belgisiz - unmarked
plaj - beach
hamak - hamak
durum - situation
günlük tutuyorum - i keep a diary
en iyi sensin - you are the best
bence yaygın - i think it's common
bitmedi - it's not over
mümkün - possible
sadece on yaşındaki çocuklar için - only for ten year olds
küçük çocuklar için - for young children
daha karpuz kesecektik - we we're going to cut more watermelons
bulaşık deterjanı - dish soap
oruç tuttuğumda - when i fast
göz önünde - in view
ödlek - coward
stil - style
mezar - grave
sorumluluk - responsibility
beklediğimden daha fazla - more than i expected
uzun bir koşuya çıktım - i went for a long run
on kilometre koşarım diye planlandım - i planned to run ten kilometers
on altı kilometreden biraz fazla koştum - i ran a little over sixteen kilometers
koştuğum yer - where i run
dağa doğru koştum - i ran towards the mountain
dağlara koştum - i ran to the mountains
otelime gidiş yolundan farklı bir yoldan geldim - i came by a different route than the way to my hotel
böylelikle - thus
daire - apartment
oluşturdum - i created
otele geldiğimde - when i come to the hotel
balık ağı - fishing net
sayı - number
tablo - table
ayakta masa - standing desk
soğan - onion
domates - tomatoes
avokado - avokado
brokoli - broccoli
tuz - salt
gününe devam etmeye hazır mısın - are you ready to continue your day
hayat sana güzel - life is good to you
kesin değil - not certain
kasım - november
türkiye'yi özledin mi ama doğruyu söyle - did you miss turkey but tell the truth
yarın doğum günü onun - tomorrow is her birthday
denize yakınım - i am near the sea
on kere on nedir - what is ten times ten
sabırsızlıkla - impatiently
çöpü - trash
geliştiriyor - is developing
izlemek zevkli - fun to watch
hatice ile çalışmayı bitirdikten sonra - after you finish working with hatice
tarih - date or history
matematiğin tarihçesi - history of mathematics
kırk bir kelime ekledim - i added fortyone words
bitiriyorum - i'm finishing
önce ingilizce sonra türkçe - first english and then turkish
yapmamam gerektiğini - that i shouldn't
geçen birkaç gün - the past few days
anki kartları yaptım - i made the anki cards
ağı olan balıkçılar - fishermen with a net
çok zamanını aldı - took a lot of time
yakaladılar - they caught
doğudaki dağlara - to the eastern mountains
iki hafta içinde - in two weeks
pazar günü - sunday
pazartesi günü - monday
salı günü - tuesday
çarşamba günü - wednesday
perşembe günü - thursday
cuma günü - friday
cumartesi günü - saturday
döndü - returned
ocak - fireplace
şubat - february
mart - march
nisan - april
mayıs - may
haziran - june
temmuz - july
ağustos - august
eylül - september
ekim - october
aralık - range or december
çocuklara kim baktı - who looked after the children
dün selma onlara baktı - yesterday selma looked at them
ağaçta neyi gördün erdoğan - what did you see in the tree erdogan
ağaçta kediyi gördüm baba - i saw the cat in the tree dad
kutuda ne buldun erdoğan - what did you find in the box erdogan
şekeri fincandan kim aldı - who took the sugar from the cup
on kilometre koşmayı planladım - i planned to run ten kilometers
bulaşık mı kullanmıyorsunuz - don't you use the dishes
sofrada yemeye alıştık - we are used to eating on the traditional sheet
fakir - poor
doydun mu - are you full
çok doydum - i'm so full
çikolata yiyeceğim - i will eat chocolate
temizleyeceğim - i will clean
bugün çok anki kart yaptım - i made a lot of anki cards today
ama kaç tane bilmiyorum - but i don't know how many
gidiyorum artık - i'm leaving now
kahvesi meşhur - famous for coffee
zemin - ground
kapı - gate
koyu kahverengi kapı - dark brown door
beyaz duvar - white wall
yeşil kanepe - green sofa
kağıt havlu - paper towel
prizi - socket
fırın - oven
dondurucu kapalı - the freezer is closed
lavabo - washbasin
dolap - cabinet
küçük beyaz lamba - small white lamp
ince perde - sheer curtain
bar sandalyesi - bar chair
modem - modem
klima çok iyi çalışıyor - air conditioner works very well
filmi durduruyorum - i stop the movie
aç olduğum için yemek yiyorum - i eat because i'm hungry
çöpü çöpe atıyorum - i throw the trash away
filme başlamalı mıyım - should i start the movie
yemek alıyorum bir şey ister misin - i'm getting food do you want something
bu film çok mu korkunç - is this movie so scary
bu film çok mu sıkıcı - is this movie so boring
başka bir şey izlemek ister misin - do you want to watch something else
bulaşıkları yıkamak zorunda değilsin sadece rahatla - you don't have to do the dishes just relax
cidden onları beraber yıkayabiliriz gel otur - seriously we can wash them together come sit down
bulaşık yıkıyorum - i am washing the dishes
kanın başıma gittiğini hissediyorum - i feel the blood go to my head
hiçbir zaman ingilizce düşünmeyi zaman kaybı olarak görmedim - i never saw thinking in english as a waste of time
bu bitki sukulent - this plant is succulent
bu ne tür bir bitki bilmiyorum - i don't know what kind of plant this is
bence bu bikti lavanta - i think this plant is lavender
bu sanatsal bir lavabo - this is an artistic sink
ellerini bu sabunla yıka - wash your hands with this soap
bu prizi çalişmıyor - this plug is not working
bu prizi bozuk - this plug is broken
bu kutu güzel kokuyor - this box smells good
tuvalette oturuyorum - i'm sitting on the toilet
bu tuvalet kağıdı - this toilet paper
burası bisikletimi tuttuğum oda - this is the room where i keep my bike
şehre - to the city
bugün ne mektebe gittim ne de şehre - i neither went to school nor to the city today
bugün ne okula gittim ne de şehre - i neither went to school nor to the city today
o halde - in that case
iyi çok ol - be very good
yalnız bir şehir gördüm - i only saw one city
oraya beş altı defa gittim - i went there five or six times
çok az kaldı - im almost there
geldim geldim - i came i came
çok yaşa - bless you
ahmet gitti mi - has ahmed gone
ahmet mi gitti - is ahmed gone
kitabı size verdiler mi - did they give you the book
selma iki çocuğu gördü mü - did selma see the two children
niçin parayı bize vermediniz - why didn't you give us the money
gelsinler mi gelmesinler mi - should they come or not
ahmet niçin gelmesin - why shouldn't ahmet come
hiçbir şey içmedi - didn't drink anything
hiç ankaraya gittiler mi - have they ever been to ankara
gazeteyi babaya verdin mi - did you give the newspaper to your father
odada ne buldun - what did you find in the room
orada hiçbir şey bulmadım - i didn't find anything there
ahmet gazeteyi okusun mu okumasın mı - should ahmet read the newspaper or not
tuvaletimi yapıyorum - i'm going to the bathroom
bulaşık mı yıkıyorsun - are you washing the dishes
neden masa kullanmıyorsunuz - why don't you use table
hiç istanbula gittiniz mi - have you ever been to istanbul
dün o mu geldi - did he come yesterday
dün mü geldi - did it come yesterday
dün geldi mi - did he come yesterday
o mu geldi - did he come
geldi mi - did he come
kız hiç gülmedi - the girl never laughed
hiç gitmedi mi - never gone
radyo sahibi - radio owner
radyonun sahibi - owner of the radio
ev sahibinizin radyosunu kimin otomobiline koydular - whose car did they put your landlord's radio in
halı - state or rug
kaşık mı çatal mı istersin - do you want a spoon or a fork
bu tahta kaşığı kullanabiliriz - we can use this wooden spoon
bir kase ister misin - do you want a bowl
bana bir tabak getirir misin - can you bring me a plate
yatak odası - bedroom
yatak odam - my bedroom
onun yatak odası - his bedroom
halının sahibi - the owner of the carpet
halının bir sahibi - an owner of the carpet
bir halının bir sahibi - an owner of a carpet
halıların sahibi - owner of carpets
halıların bir sahibi - an owner of carpets
halı sahibi - carpet owner
bir halı sahibi - owner of a carpet
halı sahipleri - carpet owners
halının iki sahibi - two owners of the carpet
iki halı sahibi - two carpet owners
bahçeni gördüler - they saw your garden
bahçesini gördüler - they saw your garden
onların bahçesini gördüler - they saw their garden
onların bahçelerini gördüler - they saw their gardens
babasının evi istanbul'da - his father's house is in istanbul
kız annesine güldü - the girl laughed at her mother
kitabını buldu - found his book
çocuklar annelerine baktılar - the children looked after their mother
kitaplarını bulmadılar - they didn't find their book
senin kitaplarını bulmadılar - they didn't find your books
parayı evlerinde buldu - found the money in their home
parayı onların evinde buldu - found the money in their house
parayı ahmedin ceplerinde buldu - he found the money in ahmed's pockets
çocuklarınız dün sabah ahmedin annesinin evinde iki saat kaldılar - your children stayed at ahmet's mother's house for two hours yesterday morning
küçük oğlunuzun ceplerinde ahmedin babasının beş lirasını buldum - i found ahmet's father's five liras in your little son's pockets
kendi kitabım - my own book
kendi kitabı - own book
kendi kitabın - your own book
kendi kitabınız - your own book
kendi kitapların - your own books
kendi kitaplarımız - our own books
kendi kitaplarınız - your own books
onların kendi kitapları - their own books
kendine geldi - he came to himself
kendi kendine geldi - he came of his own accord
baban kim - who is your father
şehrin suyu çok iyi - city water is very good
babaları oraya girmesinler - don't let their parents go there
halı sahibi parayı aldı - carpet owner took the money
türk alfabesi kolay - turkish alphabet easy
türk lisanı zor mü - is turkish language difficult
ders odamız sıcak - our classroom is warm
ama hala türkçe öğrendiğim için sorun yok - but it's okay since i'm still learning turkish
birkaç cümle yazmak uzun sürmüyor - it doesn't take long to write a few sentences
yazdığım ilk şey - first thing i wrote
karadağ'ın başkentindeyim podgerisa - i am in the capital of montenegro podgerisa
bugün belki kestireceğim - maybe i'll take a nap today
sadece üç dört saat uyudum - i only slept three or four hours
sadece ne kadar özel olduğunu bilmeni istiyorum - i just want you to know how special you are
kesinlikle sana yeşil kart verecekler - they will definitely give you a green card
bakabilir miyim - may i look
bil bakalım ne oldu - guess what happened
dört yere sordum ama hiç yok - i asked four places but none
zaten beyza ile misin - are you already with beyza
panjurlar sıkışmış - shutters stuck
ders odamızda kimi buldunuz - who did you find in our lecture room
kardeşimin ev sahibi otomobilini babamın garajına koydu - my brother's landlord put his car in my father's garage
otomobil beyoğlundan istanbul üniversitesine gitti - the automobile went from beyoğlu to istanbul university
küçük kız kardeşinin çay fincanları güzel - your little sister's teacups are beautiful
ev sahibimin kendi evi istanbul caddesinde - my host's own house is on istanbul street
oğlunun ayakları büyük - your son has big feet
küçük kardeşinin ismi ne - what is your little brother's name
ahmedin kız kardeşi dün gece niçin kız kardeşlerinin evine gitmedi - why didn't ahmed's sister go to her sisters' house last night
hiç beyoğluna gittin mi - have you ever been to beyoğlu
neredeyse bir hafta oldu yazmadım - i haven't written for almost a week
bu sabah nehirde yüzdüm - i swam in the river this morning
eve geldiğimde onları pişirdim - i cooked them when i got home
şu anda programlama yapacağım - i'm programming right now
belki az yazarsam yarın daha çok yazarım - maybe if i write less i will write more tomorrow
yazı yazmanın çok uzun ve zor olduğunu düşünmek istemiyorum - i don't want to think that writing is too long and hard
ama kısa kısa yazarsam başka günler evet yazı yazabilirim diyebilirim kendime - but if i write short i can say to myself that i can write on other days
fakat bu çok kısa olacak çünkü başka şeyler de yapmak istiyorum - but this will be very short because i want to do other things too
marketten yeni çıktım - i just left the market
düştün mü - did you fall
düş aldın mı - did you dream
bahçelerine gördüler - they saw in their garden
düş aldım - i had a shower
duşta mıydın - we're you in the shower
ıspanak - spinach
okumayı çok sever - loves to read
o kitabı okumadan size verdim - i gave it to you without reading that book
oraya gitmek çok zor - it is very difficult to go there
ingilizcede bu söz ne demek - what does this word mean in english
onu görmeye geldiler - they came to see him
yüzmek bilmez - can't swim
ingilizcede bilmezler mi - don't they know english
postacı günde iki defa gelir - the postman comes twice a day
ben eve gelir gelmez size telefon ettim - i phoned you as soon as i got home
bu sabah onu okumadan bana verdi - gave it to me this morning without reading it
son zamanlarda ne yapıyorsun - what are you doing lately
buranın doğusunda - east of here
buranın güneyinde - south of here
dağlık bir ülke mi - is it a mountainous country
yüzme gözlüklerimi gördün mü - have you seen my swimming goggles
birkaç dakika önce bisikletime bindim - a few minutes ago i got on my bike
kapının yanında tutuyorlar - they keep it by the door
sorunlar - problems
dil öğrenmede gerçekten iyi - really good at learning languages
bilim insanları - scientists
iyi ki varsın - so glad i have you
iradeyi güçlendirdiği - strengthens the will
kelimenin anlamını - the meaning of the word
kumsala - to the beach
denize - to the sea
gelenek - tradition
iki paragraf - two paragraphs
irade - will
yaratacaktı - would create
daha uzun yazmak - write longer
günlük yazarken - writing a diary
çalışmayı bitirdin - you finished working
yapmam gereken başka şeyler var - i have other things to do
filmi durdurmalı mıyım - should i stop the movie
kestirdim - i took a nap
buzdolabı açık - refrigerator open
eritecek - will melt
barfiks çektim - i did a pullup
ilgili - relating to
buranın batısında - west of here
bu giderek uzuyor - this is getting longer
bir haritaya baktım - i looked at a map
sarı tabure - yellow stool
ama sonra alışıyordum - but then i got used to it
