the lion and the mouse - aslan ve fare - no hint
once upon a time there lived a lion - bir zamanlar bir aslan yaşarmış - no hint
ormana hükmetti - ruled the forest - no hint
yemeğini yedikten bir gün sonra - one day after eating his meal - no hint
aslan bir ağacın altında uyuyakaldı - the lion fell asleep under a tree - no hint
küçük bir fare onu gördü - a little mouse saw him - no hint
üzerinde oynamanın eğlenceli olacağını düşündüm - thought it would be fun to play on it - no hint
uyuyan aslanı aşağı yukarı koşmaya başladı - he began running up and down the sleeping lion - no hint
kuyruğunu koştu - he ran up the tail - no hint
yüksek sesle kükreme - the loud roar - no hint
fareyi yakaladı - he grabbed the mouse - no hint
onun büyük pençesi ile - with his huge paw - no hint
fare mücadele etti - the mouse struggled - no hint
ama aslandan kaçamadı - but could not escape the lion - no hint
onun büyük çenelerinin üzerinde - over his big jaws - no hint
onu yutmak - to swallow him - no hint
fare çok korktu - the mouse was very scared - no hint
onu asla unutmayacağım - i shall never forget it - no hint
belki bir gün sana yardım edebilirim - maybe one day i can help you - no hint
aslan çok eğlendi - the lion was so amused - no hint
fikir tarafından - by the idea - no hint
farenin ona yardım edebilmesi - of the mouse being able to help him - no hint
patisini kaldırdı - he lifted up his paw - no hint
bırak onu - let him go - no hint
şanslısın arkadaşım - you are lucky my friend - no hint
daha yeni yedim - i've just eaten - no hint
şimdi git ama bir daha benimle uğraşma - now go but don't mess with me again - no hint
sana yemek yapacağım - i will make a meal of you - no hint
birkaç gün sonra aslan ormanda dolaşıyordu - a few days later the lion was roaming the jungle - no hint
avcılar aslanı yakalamak için tuzak kurdu - hunters set a trap to catch the lion - no hint
avcılar ağacın arkasına saklandı - the hunters hid behind the tree - no hint
aslanı beklemek - waiting for the lion - no hint
tuzağa yaklaşmak - to approach the trap - no hint
yaptığı gibi - as he did - no hint
avcılar ipleri çekti - the hunters pulled the ropes - no hint
aslan başladı - the lion started - no hint
kaçmaya çalış - try to escape - no hint
avcılar - the hunters - no hint
köye geri döndüler - they went back to the village - no hint
araba getirmek - to bring a cart - no hint
aslanı taşımak - to transport the lion - no hint
aslan hala yüksek sesle savaşıyordu - the lion was still warring loudly - no hint
bütün hayvanlar - all the animals - no hint
fare dahil - including the mouse - no hint
başı belada - is in trouble - no hint
mecburum - i must - no hint
yakında aslana ulaştı - he soon reached the lion - no hint
merak etme - don't worry - no hint
kralım - my king - no hint
seni özgür bırakacağım - i will set you free - no hint
o tırmandı - he climbed up - no hint
tuzak - the trap - no hint
ve kısa küçük dişlerini kullandı - and used his short little teeth - no hint
sonunda aslanı kurtardı - finally he freed the lion - no hint
tuzaktan - from the trap - no hint
aslan anladı - the lion realized - no hint
küçük bir fare bile - even a little mouse - no hint
harika bir yardım olabilir - can be a great help - no hint
teşekkürler fare - thank you mouse - no hint
seni bir daha asla rahatsız etmeyeceğim - i will never trouble you again - no hint
mutlu yaşayacağız - we'll live happily - no hint
ormanımda - in my forest - no hint
kurtardı - he saved - no hint
bir kralın hayatı - a king's life - no hint
şimdi sen prenssin - now you are the prince - no hint
bu ormanın - of this forest - no hint
teşekkürler kral - thank you king - no hint
hoşçakal görüşmek üzere - bye see you soon - no hint
ah nereye gidiyorsun - ah where are you going - no hint
istemiyor musun - don't you want - no hint
fare zıplamaya başladı - the mouse started jumping - no hint
sırtında - on his back - no hint
kuyruğundan aşağı kayıyor - sliding down his tail - no hint
bir süre sonra - after a while - no hint
avcılar geri geldi - the hunters came back - no hint
büyük bir araba ile - with a big cart - no hint
aslanı taşımak - to carry the lion - no hint
aslan - the lion - no hint
bir fare onları gördü - a mouse saw them - no hint
ve onlara doğru koşmaya başladı - and started running towards them - no hint
büyük bir kükreme bıraktı - gave up a big roar - no hint
dehşete düştüğümüz avcılar - the hunters we're terrified - no hint
kaçtı - ran away - no hint
köye geri dön - back to the village - no hint
aslan ve fare oldu - a lion and mouse became - no hint
sonsuza kadar arkadaş - friends forever - no hint
aslan - lion - no hint
ve - and - no hint
fare - do - no hint
bir - a - no hint
varmış - there is - no hint
yokmuş - gone - no hint
ormana - closet - no hint
hükmeden - governing - no hint
gün - day - no hint
yemeğini - your meal - no hint
yedikten - after eating - no hint
sonra - later - no hint
ağacın - the tree - no hint
altında - under - no hint
uyuyakalmışım - i fell a sleep - no hint
küçük - small - no hint
onu - him/her/it - no hint
görmez - does not see - no hint
aslanın - your lion - no hint
üstünde - above - no hint
oynamanın - of playing - no hint
eğlenceli - entertaining - no hint
olacağını - would be - no hint
düşünmüştüm - i thought - no hint
uyuyamam - i can't sleep - no hint
üzerinde - on - no hint
aşağı - down - no hint
yukarı - above - no hint
koşturmaya - to run - no hint
başlamış - started - no hint
kuyruğundan - from the tail - no hint
tırmanıyor - climbing - no hint
anlaşalım - let's get along - no hint
köfte - meatball - no hint
içinde - inside - no hint
gül - rose - no hint
kurusu - dried - no hint
ile - with - no hint
kükreyerek - roaring - no hint
uyanmışlar - they woke up - no hint
kocaman - huge - no hint
ilçesiyle - with the county - no hint
fareyi - mouse - no hint
yakalamış - caught - no hint
karşı - against - no hint
koymuş - have put - no hint
fakat - but - no hint
kaçırmamış - didn't miss - no hint
koruyucu - protector - no hint
tutmak - to hold - no hint
üzere - about to - no hint
okus - taste - no hint
ağzını - your mouth - no hint
açmış - opened - no hint
farem - farem - no hint
çok - lots - no hint
korkunç - terrible - no hint
kıralım - let's break - no hint
korkuyorum - i am scared - no hint
lütfen - please - no hint
beni - me - no hint
yemeği - food - no hint
ama - but - no hint
sen - its - no hint
boş - null - no hint
senin - monday - no hint
izin - permission - no hint
verin - give - no hint
gidip - go and go - no hint
oo - oo - no hint
elim - my hand - no hint
saat - moment - no hint
da - gives - no hint
unutma - do not forget - no hint
belki - maybe - no hint
ben - ben - no hint
de - from - no hint
size - size - no hint
yardım - help - no hint
ederim - i do - no hint
sana - to you - no hint
farenin - the mouse - no hint
kendisine - to herself - no hint
edebilme - able to - no hint
ihtimaline - to the possibility - no hint
şaşırmış - surprised - no hint
eğlencesine - for fun - no hint
gitmesine - to go - no hint
şükrederim - thank you - no hint
kralı - king of - no hint
polis - police - no hint
anketimize - survey - no hint
asla - never - no hint
unutmayacağım - i will not forget - no hint
vermediğim - i didn't give - no hint
için - for - no hint
şanslısın - you are lucky - no hint
dostum - mate - no hint
şimdi - now - no hint
git - go - no hint
daha - more - no hint
benimle - with me - no hint
uğraşma - hassle - no hint
yoksa - or - no hint
seni - you - no hint
mideye - to the stomach - no hint
indirelim - indirelim - no hint
birkaç - a few - no hint
ormanda - in the forest - no hint
gezintiye - take a stroll - no hint
çıkmış - out - no hint
avcılar - hunters - no hint
aslanı - lion - no hint
yakalamak - to capture - no hint
tuzak - trap - no hint
kurmuşlar - they established - no hint
aslanını - your lion - no hint
tuzağa - trapped - no hint
yaklaşmasını - to approach - no hint
beklemek - to wait - no hint
arkasına - behind - no hint
saklanmışlar - they hid - no hint
baskılarına - to prints - no hint
ipleri - ropes - no hint
cicişler - chicks - no hint
yakalanmıştı - was caught - no hint
hasan - hasan - no hint
var - where - no hint
gücünde - in strength - no hint
kükremiş - roared - no hint
kaçmaya - to run away - no hint
çalışır - works - no hint
orada - there - no hint
o - o - no hint
civara - civara - no hint
sıkıca - firmly - no hint
bağlamışlar - they tied - no hint
hastanın - the patient - no hint
taşımak - to carry - no hint
büyük - big - no hint
yük - burden - no hint
arabası - car - no hint
getirmek - to bring - no hint
dönmüşler - they returned - no hint
kükremeye - to roar - no hint
devam - continue - no hint
ediyormuş - he was doing - no hint
dahil - because - no hint
tüm - all - no hint
hayvanlar - animals - no hint
kükrediğini - you roar - no hint
duymuştur - has heard - no hint
başı - head - no hint
dertte - in trouble - no hint
iyiliğinin - your well/being - no hint
karşılığını - pay off - no hint
ödemeliyiz - we must pay - no hint
hemen - now - no hint
yanına - next - no hint
gitmiş - gone - no hint
merak - curiosity - no hint
etmeyin - don't - no hint
sizi - you - no hint
kurtaracağım - i will save - no hint
kahve - coffee - no hint
tırmanmış - climbed - no hint
keskin - sharp - no hint
dişleriyle - with his teeth - no hint
kemirmeye - to gnaw - no hint
sonunda - finally - no hint
kurtarmış - saved - no hint
küçücük - tiny - no hint
bile - even - no hint
yardımı - help - no hint
olabileceğini - may be - no hint
anlamıştır - understood - no hint
göcek - gocek - no hint
kür - kur - no hint
rahatsız - uncomfortable - no hint
etmeyeceğim - i will not - no hint
ormanında - in the forest - no hint
mutlu - happy - no hint
şekilde - way - no hint
ya - yes - no hint
şaka - joke - no hint
kurtardın - you saved - no hint
artık - now - no hint
bu - this - no hint
ormanın - of the forest - no hint
prensesim - my princess - no hint
teşekkür - thanks - no hint
hoşçakalın - goodbye - no hint
görüşmek - to meet - no hint
diyorsun - you say - no hint
oynamak - play - no hint
kuyruğunda - in the queue - no hint
kaymak - cream - no hint
istemez - don't want - no hint
misin - will you - no hint
sırtında - on your back - no hint
zıplamaya - to jump - no hint
kaymaya - to slip - no hint
süre - duration - no hint
arabasıyla - by car - no hint
çıkan - coming out - no hint
gelmişler - they came - no hint
onları - them - no hint
görmüş - seen - no hint
üzerlerine - on them - no hint
doğru - accurate - no hint
koşmaya - to run - no hint
başlamışlar - they started - no hint
görüntüde - in the image - no hint
dehşet - horror - no hint
içindeymiş - was in - no hint
köye - to village - no hint
başlamışlardı - they started - no hint
sonsuza - forever - no hint
dek - dek - no hint
arkadaş - friend - no hint
olmuşlar - have been - no hint
