Inglizce Rüya Kelime Tam

dreaming - rüya görmek - no hint
lucid - anlaşılır - no hint
dream - rüya - no hint
dreams - rüyalar - no hint
physical - fiziksel - no hint
astral - astral - no hint
sleep - uyku - no hint
consciousness - bilinç - no hint
projection - projeksiyon - no hint
upon - üzerine - no hint
awareness - farkındalık - no hint
earth - Dünya - no hint
conscious - bilinçli - no hint
waking - uyanma - no hint
practice - uygulama - no hint
experiences - deneyimler - no hint
phase - evre - no hint
reality - gerçeklik - no hint
techniques - teknikler - no hint
technique - teknik - no hint
felt - keçe - no hint
looked - baktı - no hint
seemed - görünüyordu - no hint
brain - beyin - no hint
mental - zihinsel - no hint
cannot - olumsuz - no hint
spiritual - manevi - no hint
plane - uçak - no hint
subject - konu - no hint
lucidity - netlik - no hint
beyond - ötesinde - no hint
aware - farkında - no hint
perhaps - belki - no hint
feeling - duygu - no hint
fear - korku - no hint
hands - eller - no hint
guide - kılavuz - no hint
simply - basitçe - no hint
asleep - uykuda - no hint
learn - öğrenmek - no hint
turned - döndü - no hint
knowledge - bilgi - no hint
nature - doğa - no hint
thoughts - düşünceler - no hint
spirit - ruh - no hint
feet - ayak - no hint
dreamer - hayalperest - no hint
seem - görünmek - no hint
itself - kendisi - no hint
attention - Dikkat - no hint
deep - derin - no hint
method - yöntem - no hint
usually - genelde - no hint
awake - uyanık - no hint
completely - tamamen - no hint
knew - biliyordu - no hint
travel - seyahat - no hint
inner - iç - no hint
focus - odak - no hint
thus - Böylece - no hint
split - Bölünmüş - no hint
door - tarafından - no hint
lama - uzun - no hint
condition - şart - no hint
inside - içeride - no hint
suddenly - aniden - no hint
normal - normal - no hint
strange - garip - no hint
natural - doğal - no hint
books - kitabın - no hint
indeed - aslında - no hint
experienced - Tecrübeli - no hint
chapter - bölüm - no hint
memory - hafıza - no hint
sound - ses - no hint
ability - kabiliyet - no hint
effect - etki - no hint
moving - hareketli - no hint
vision - vizyon - no hint
tried - denenmiş - no hint
soul - ruh - no hint
effort - çaba - no hint
material - malzeme - no hint
wake - uyanmak - no hint
movement - hareket - no hint
flying - uçan - no hint
dreamers - hayalperestler - no hint
sensation - duygu - no hint
stage - sahne - no hint
particular - belirli - no hint
exercise - egzersiz yapmak - no hint
imagine - hayal etmek - no hint
appear - görünmek - no hint
individual - bireysel - no hint
journey - seyahat - no hint
becomes - olur - no hint
simple - basit - no hint
fully - tamamen - no hint
bodies - bedenler - no hint
difficult - zor - no hint
longer - uzun - no hint
sensations - duyumlar - no hint
various - çeşitli - no hint
fall - sonbahar - no hint
whatever - her neyse - no hint
attempt - girişim - no hint
existence - varoluş - no hint
enter - giriş - no hint
began - başladı - no hint
begin - başla - no hint
immediately - hemen - no hint
double - çift - no hint
falling - düşme - no hint
slowly - yavaşça - no hint
hold - ambar - no hint
voice - ses - no hint
wall - duvar - no hint
object - nesne - no hint
desire - arzu etmek - no hint
sight - görme - no hint
practitioner - uygulayıcı - no hint
trance - trans - no hint
projected - öngörülen - no hint
center - merkez - no hint
author - yazar - no hint
follow - takip et - no hint
recall - hatırlama - no hint
awakening - uyanış - no hint
ground - zemin - no hint
memories - anılar - no hint
events - Etkinlikler - no hint
universe - Evren - no hint
lives - hayatları - no hint
seeing - görme - no hint
likely - muhtemelen - no hint
complete - tamamlayınız - no hint
activity - aktivite - no hint
ways - yollar - no hint
forms - formlar - no hint
path - yol - no hint
easily - kolayca - no hint
therefore - bu nedenle - no hint
continue - devam et - no hint
understanding - anlayış - no hint
belief - inanç - no hint
occur - meydana gelmek - no hint
happen - olmak - no hint
questions - sorular - no hint
environment - çevre - no hint
project - proje - no hint
themselves - kendilerini - no hint
answer - Cevap - no hint
beings - Varlıklar - no hint
write - yazmak - no hint
create - oluşturmak - no hint
step - adım - no hint
moved - taşındı - no hint
yoga - yoga - no hint
takes - alır - no hint
learning - öğrenme - no hint
images - Görüntüler - no hint
image - görüntü - no hint
exit - çıkış - no hint
vibrations - titreşimler - no hint
direct - direkt - no hint
quickly - hızlı bir şekilde - no hint
dark - karanlık - no hint
unconscious - bilinçsiz - no hint
necessary - gerekli - no hint
subconscious - bilinçaltı - no hint
happened - olmuş - no hint
objects - nesneler - no hint
realize - farkına varmak - no hint
energetic - enerjik - no hint
pain - Ağrı - no hint
planes - planlar - no hint
table - masa - no hint
green - yeşil - no hint
paralysis - felç - no hint
journal - günlük - no hint
familiar - tanıdık - no hint
actions - hareketler - no hint
closed - kapalı - no hint
wish - dilek - no hint
senses - duyular - no hint
exist - var olmak - no hint
throughout - boyunca - no hint
realm - Diyar - no hint
picture - resim - no hint
surface - yüzey - no hint
entire - tüm - no hint
sleeping - uyuyor - no hint
note - Not - no hint
humans - insanlar - no hint
basic - temel - no hint
truth - hakikat - no hint
meaning - anlam - no hint
distance - mesafe - no hint
consider - düşünmek - no hint
interesting - ilginç - no hint
situation - durum - no hint
beginning - başlangıç - no hint
remain - kalmak - no hint
imagination - hayal gücü - no hint
towards - doğru - no hint
breath - nefes - no hint
directly - direkt olarak - no hint
sounds - sesler - no hint
exactly - kesinlikle - no hint
eventually - Sonuçta - no hint
decided - karar - no hint
reading - okuma - no hint
ideas - fikirler - no hint
appears - belirir - no hint
presence - mevcudiyet - no hint
master - usta - no hint
alone - tek başına - no hint
becoming - olma - no hint
cases - vakalar - no hint
merely - sadece - no hint
standing - ayakta - no hint
visit - ziyaret etmek - no hint
lower - daha düşük - no hint
extremely - son derece - no hint
worlds - dünyalar - no hint
breathing - nefes - no hint
specific - özel - no hint
appeared - ortaya çıktı - no hint
gone - gitti - no hint
passed - geçti - no hint
levels - seviyeleri - no hint
greater - daha büyük - no hint
happens - olur - no hint
allow - izin vermek - no hint
caused - neden oldu - no hint
lying - yalan söylemek - no hint
window - pencere - no hint
direction - yön - no hint
methods - yöntemler - no hint
exercises - egzersizler - no hint
page - sayfa - no hint
finally - en sonunda - no hint
reached - ulaştı - no hint
parts - parçalar - no hint
healing - iyileştirme - no hint
floor - zemin - no hint
touch - dokunma - no hint
legs - bacaklar - no hint
meditation - meditasyon - no hint
carefully - dikkatli - no hint
sitting - oturma - no hint
below - altında - no hint
arms - silâh - no hint
stood - durdu - no hint
speed - hız - no hint
perception - algı - no hint
described - tarif - no hint
brought - getirdi - no hint
walked - yürüdü - no hint
relaxation - rahatlama - no hint
divine - ilahi - no hint
learned - öğrendi - no hint
sort - çeşit - no hint
figure - şekil - no hint
psychic - psişik - no hint
toward - doğru - no hint
occult - gizli - no hint
cord - kordon - no hint
file - dosya - no hint
exploring - keşif - no hint
opportunity - fırsat - no hint
otherwise - aksi takdirde - no hint
whose - kimin - no hint
cycle - döngü - no hint
false - yanlış - no hint
impossible - imkansız - no hint
scene - faliyet alani, sahne - no hint
deeper - Daha derine - no hint
scientific - ilmi - no hint
ultimate - nihai - no hint
moments - anlar - no hint
ourselves - kendimizi - no hint
daily - günlük - no hint
wind - rüzgar - no hint
feels - hissediyor - no hint
amount - Miktar - no hint
considered - düşünülen - no hint
explore - keşfetmek - no hint
apparently - görünüşe göre - no hint
twenty - yirmi - no hint
certainly - kesinlikle - no hint
areas - alanlar - no hint
develop - geliştirmek - no hint
explain - açıklamak - no hint
occurs - oluşur - no hint
event - Etkinlik - no hint
wonder - merak etmek - no hint
task - görev - no hint
aspects - yönler - no hint
terms - şartlar - no hint
subtle - ince - no hint
difference - fark - no hint
awaken - uyanmak - no hint
influence - etkilemek - no hint
notice - farkına varmak - no hint
training - Eğitim - no hint
achieve - başarmak - no hint
knowing - bilmek - no hint
vivid - canlı - no hint
unless - sürece - no hint
absolutely - kesinlikle - no hint
unusual - alışılmadık - no hint
entirely - Baştan sona - no hint
powerful - güçlü - no hint
places - yerler - no hint
approach - yaklaşmak - no hint
flow - akış - no hint
truly - gerçekten - no hint
source - kaynak - no hint
share - Paylaş - no hint
primary - birincil - no hint
walk - yürümek - no hint
religion - din - no hint
science - Bilim - no hint
lived - yaşadı - no hint
writing - yazı - no hint
goal - hedef - no hint
occurred - oluştu - no hint
intention - niyet - no hint
developed - gelişmiş - no hint
forward - ileri - no hint
spirits - ruhlar - no hint
animals - hayvanlar - no hint
ancient - Antik - no hint
religious - dini - no hint
clearly - Açıkça - no hint
written - yazılı - no hint
beautiful - güzel - no hint
continued - devam etti - no hint
manner - tavır - no hint
interested - Ilgilenen - no hint
whom - kime - no hint
copy - kopya - no hint
record - kayıt - no hint
highly - büyük ölçüde - no hint
success - başarı - no hint
related - ilişkili - no hint
increase - artırmak - no hint
experiment - Deney - no hint
perform - icra etmek - no hint
needed - gerekli - no hint
seven - Yedi - no hint
floating - yüzer - no hint
deeply - derinden - no hint
trees - ağaçlar - no hint
leaving - ayrılma - no hint
consciously - bilinçli olarak - no hint
shadow - gölge - no hint
afraid - korkmuş - no hint
poor - yoksul - no hint
creative - yaratıcı - no hint
positive - pozitif - no hint
moon - ay - no hint
phenomenon - fenomen - no hint
active - aktif - no hint
solid - katı - no hint
press - basın - no hint
entered - girdi - no hint
hour - saat - no hint
seconds - saniye - no hint
slightly - biraz - no hint
emotional - duygusal - no hint
repeat - tekrar et - no hint
easier - Daha kolay - no hint
created - yaratıldı - no hint
ordinary - sıradan - no hint
reach - ulaşmak - no hint
somewhere - bir yerde - no hint
degree - derece - no hint
causes - nedenleri - no hint
born - doğmuş - no hint
normally - normalde - no hint
darkness - karanlık - no hint
actual - gerçek - no hint
walking - yürüme - no hint
attempts - denemeler - no hint
speak - konuşmak - no hint
waiting - bekleme - no hint
negative - olumsuz - no hint
imagery - görüntü - no hint
fell - düştü - no hint
effective - etkili - no hint
middle - orta - no hint
pass - geçmek - no hint
purpose - amaç - no hint
theory - teori - no hint
suffering - çile - no hint
conditions - koşullar - no hint
tree - ağaç - no hint
opened - açıldı - no hint
trouble - sorun - no hint
cold - soğuk - no hint
progress - ilerleme - no hint
relax - Rahatlayın - no hint
heavy - ağır - no hint
stand - ayakta durmak - no hint
doctor - doktor - no hint
shape - şekil - no hint
projector - projektör - no hint
blue - mavi - no hint
ones - olanlar - no hint
figures - rakamlar - no hint
projecting - projeksiyon - no hint
round - yuvarlak - no hint
contact - İletişim - no hint
projections - projeksiyonlar - no hint
dimension - boyut - no hint
recognize - tanımak - no hint
intent - niyet - no hint
realized - gerçekleştirilen - no hint
stopped - durdu - no hint
replied - cevap verdi - no hint
relaxed - rahat - no hint
monk - keşiş - no hint
kept - muhafaza - no hint
except - dışında - no hint
separation - ayrılık - no hint
perceive - algılamak - no hint
silver - gümüş - no hint
projectors - projektörler - no hint
rope - İp - no hint
centers - merkezleri - no hint
aura - sahip olacak - no hint
obtain - elde etmek - no hint
appropriate - uygun - no hint
reserved - ayrılmış - no hint
relation - ilişki - no hint
cover - örtmek - no hint
brief - kısa - no hint
nightmares - kabuslar - no hint
text - Metin - no hint
types - türleri - no hint
psychology - Psikoloji - no hint
perspective - perspektif - no hint
intense - yoğun - no hint
emotions - duygular - no hint
pleasure - Zevk - no hint
sexual - cinsel - no hint
practical - pratik - no hint
meeting - toplantı - no hint
stars - yıldızlar - no hint
developing - gelişen - no hint
communication - iletişim - no hint
edge - kenar - no hint
vast - Muazzam - no hint
alive - canlı - no hint
holding - tutma - no hint
usual - olağan - no hint
clarity - açıklık - no hint
surroundings - çevre - no hint
minds - zihinler - no hint
previous - önceki - no hint
abilities - yetenekleri - no hint
greatly - büyük ölçüde - no hint
spend - harcamak - no hint
discover - keşfetmek - no hint
beneath - altında - no hint
eight - sekiz - no hint
hundred - yüz - no hint
spent - harcandı - no hint
discuss - tartışmak - no hint
detail - detay - no hint
definitely - kesinlikle - no hint
skills - Beceriler - no hint
pleasant - hoş - no hint
shows - gösterir - no hint
details - detaylar - no hint
generally - genel olarak - no hint
required - gereklidir - no hint
desires - arzular - no hint
personality - kişilik - no hint
concept - konsept - no hint
teach - öğretmek - no hint
meant - demek - no hint
topic - konu - no hint
watching - seyretme - no hint
concentration - konsantrasyon - no hint
glass - bardak - no hint
stages - aşamalar - no hint
expect - beklemek - no hint
reports - raporlar - no hint
experiencing - deneyimleme - no hint
happening - olay - no hint
answers - Yanıtlar - no hint
habit - alışkanlık - no hint
possibility - olasılık - no hint
steps - adımlar - no hint
doubt - şüphe - no hint
creation - oluşturma - no hint
particularly - özellikle - no hint
regular - düzenli - no hint
obvious - açık - no hint
associated - ilişkili - no hint
aspect - Görünüş - no hint
response - tepki - no hint
encounter - karşılaşma - no hint
describe - tanımlamak - no hint
changing - değiştirme - no hint
feelings - hisler - no hint
somewhat - biraz - no hint
prove - kanıtlamak - no hint
accept - kabul etmek - no hint
powers - güçler - no hint
limited - sınırlı - no hint
prepared - hazırlanmış - no hint
giving - vermek - no hint
overcome - aşmak - no hint
serious - ciddi - no hint
running - koşma - no hint
wonderful - olağanüstü - no hint
taught - öğretti - no hint
potential - potansiyel - no hint
essence - öz - no hint
fears - korkular - no hint
modern - modern - no hint
subjects - konular - no hint
involved - dahil - no hint
journeys - yolculuklar - no hint
unable - yapamaz - no hint
importance - önem - no hint
western - batı - no hint
wrote - yazdı - no hint
century - yüzyıl - no hint
letter - mektup - no hint
possibly - muhtemelen - no hint
appearance - görünüm - no hint
discovered - keşfetti - no hint
perfect - mükemmel - no hint
mentioned - bahsedilen - no hint
passing - geçen - no hint
monks - keşişler - no hint
focused - odaklanmış - no hint
practices - uygulamalar - no hint
suggest - önermek - no hint
phenomena - fenomen - no hint
studies - çalışmalar - no hint
keeping - tutma - no hint
whenever - her ne zaman - no hint
advice - tavsiye - no hint
loved - sevilen - no hint
quality - kalite - no hint
induce - teşvik etmek - no hint
clock - saat - no hint
successful - başarılı - no hint
psychological - psikolojik - no hint
returning - geri dönen - no hint
experiments - deneyler - no hint
earlier - daha erken - no hint
correct - doğru - no hint
worth - değer - no hint
paper - kağıt - no hint
connection - bağ - no hint
gives - verir - no hint
woke - uyanmak - no hint
creating - oluşturma - no hint
sign - işaret - no hint
range - Aralık - no hint
sensory - duyusal - no hint
cross - çapraz - no hint
larger - daha büyük - no hint
suggestion - öneri - no hint
wide - geniş - no hint
covered - kapalı - no hint
entering - giren - no hint
noticed - farkedildi - no hint
increased - arttı - no hint
beliefs - inançlar - no hint
apparent - bariz - no hint
useful - işe yarar - no hint
followed - takip etti - no hint
knows - bilir - no hint
reported - bildirildi - no hint
straight - Düz - no hint
bright - parlak - no hint
ahead - önde - no hint
activities - aktiviteler - no hint
placed - yerleştirilmiş - no hint
changes - değişiklikler - no hint
forget - unutmak - no hint
finding - bulma - no hint
message - İleti - no hint
sent - gönderildi - no hint
muscles - kaslar - no hint
patterns - desenler - no hint
instantly - anında - no hint
elements - elementler - no hint
rate - oran - no hint
produce - üretmek - no hint
avoid - önlemek - no hint
decide - karar ver - no hint
stated - belirtilen - no hint
original - orijinal - no hint
filled - dolu - no hint
quiet - sessiz - no hint
none - Yok - no hint
radio - radyo - no hint
advanced - ileri - no hint
returned - iade - no hint
seek - aramak - no hint
weeks - haftalar - no hint
secret - gizli - no hint
creatures - yaratıklar - no hint
internal - iç - no hint
lack - eksiklik - no hint
length - uzunluk - no hint
visual - görsel - no hint
slow - yavaş - no hint
wave - dalga - no hint
helps - yardım eder - no hint
waves - dalgalar - no hint
frequency - Sıklık - no hint
lose - kaybetmek - no hint
sudden - ani - no hint
believed - inanmış - no hint
complex - karmaşık - no hint
physically - fiziksel olarak - no hint
gradually - yavaş yavaş - no hint
shift - vardiya - no hint
perfectly - kusursuzca - no hint
tired - yorgun - no hint
lights - ışıklar - no hint
naturally - doğal olarak - no hint
calm - sakin - no hint
opening - açılış - no hint
pattern - Desen - no hint
horse - at - no hint
separate - ayrı - no hint
remembered - hatırladı - no hint
bedroom - yatak odası - no hint
nearly - neredeyse - no hint
choose - Seç - no hint
strongly - şiddetle - no hint
understood - anladım - no hint
effects - Etkileri - no hint
function - işlevi - no hint
break - kırmak - no hint
difficulty - zorluk - no hint
noise - gürültü, ses - no hint
motion - hareket - no hint
comfortable - rahat - no hint
connected - bağlı - no hint
piece - parça - no hint
relationship - ilişki - no hint
minute - dakika - no hint
mentally - zihinsel olarak - no hint
notes - notlar - no hint
pick - toplamak - no hint
carry - Taşımak - no hint
pictures - resimler - no hint
entry - giriş - no hint
beside - yanında - no hint
evening - akşam - no hint
fast - hızlı - no hint
exists - var - no hint
emotion - duygu - no hint
pull - Çek - no hint
begins - başlar - no hint
asking - sormak - no hint
section - Bölüm - no hint
base - temel - no hint
observe - gözlemek - no hint
changed - değişti - no hint
added - katma - no hint
mine - benim - no hint
river - nehir - no hint
gently - nazikçe - no hint
fingers - parmaklar - no hint
vibration - titreşim - no hint
temple - tapınak şakak .. mabet - no hint
entities - varlıklar - no hint
explained - açıkladı - no hint
strength - gücü - no hint
concentrate - yoğunlaşmak - no hint
blood - kan - no hint
animal - hayvan - no hint
walls - duvarlar - no hint
medical - tıbbi - no hint
search - arama - no hint
stuff - şey - no hint
unknown - Bilinmeyen - no hint
receive - teslim almak - no hint
symbols - semboller - no hint
maintain - sürdürmek - no hint
birth - doğum - no hint
target - hedef - no hint
frequently - sık sık - no hint
flight - uçuş - no hint
somehow - bir şekilde - no hint
energies - enerjiler - no hint
ship - gemi - no hint
systems - sistemleri - no hint
chair - sandalye - no hint
symbol - sembol - no hint
pressure - basınç - no hint
turning - dönme - no hint
mirror - ayna - no hint
carried - taşınan - no hint
provide - sağlamak - no hint
worked - çalıştı - no hint
entity - varlık - no hint
clouds - bulutlar - no hint
peace - Barış - no hint
received - Alınan - no hint
mountain - dağ - no hint
structure - yapı - no hint
telling - söylüyorum - no hint
tradition - gelenek - no hint
totally - tamamen - no hint
indirect - dolaylı - no hint
heaven - cennet - no hint
stone - taş - no hint
chest - göğüs - no hint
pure - saf - no hint
rise - yükselmek - no hint
rock - Kaya - no hint
foot - ayak - no hint
miles - mil - no hint
teacher - öğretmen - no hint
amazing - inanılmaz - no hint
dimensional - boyutlu - no hint
golden - altın - no hint
visualization - görselleştirme - no hint
impression - izlenim - no hint
sacred - kutsal - no hint
thousand - bin - no hint
neck - boyun - no hint
thousands - binlerce - no hint
faith - inanç - no hint
evil - kötü - no hint
forth - ileri - no hint
visualize - görselleştirmek - no hint
rose - gül - no hint
pulled - çekti - no hint
perceived - algılanan - no hint
instance - örnek - no hint
hospital - hastane - no hint
location - yer - no hint
colors - renkler - no hint
color - renk - no hint
hair - saç - no hint
phantom - hayalet - no hint
zone - bölge - no hint
flesh - et - no hint
silence - Sessizlik - no hint
warm - Ilık, hafif sıcak - no hint
cave - mağara - no hint
fairly - oldukça - no hint
entrance - Giriş - no hint
cats - kediler - no hint
stored - saklanmış - no hint
recording - kayıt - no hint
prior - önceki - no hint
claims - iddialar - no hint
published - yayınlanan - no hint
subsequent - sonraki - no hint
courage - cesaret - no hint
contents - içerik - no hint
shadows - gölgeler - no hint
dawn - şafak - no hint
saint - aziz - no hint
filling - dolgu - no hint
landscape - manzara - no hint
hallucinations - halüsinasyonlar - no hint
awakenings - uyanışlar - no hint
bare - sadece - no hint
testing - test yapmak - no hint
nose - burun - no hint
tests - testler - no hint
induction - indüksiyon - no hint
mild - hafif - no hint
expectation - beklenti - no hint
partner - ortak - no hint
increasing - artan - no hint
maintaining - sürdürme - no hint
situations - durumlar - no hint
shock - şok - no hint
controlling - kontrol - no hint
magic - büyü - no hint
doors - kapılar - no hint
realities - gerçekler - no hint
creativity - yaratıcılık - no hint
lies - yalanlar - no hint
boat - tekne - no hint
preparation - hazırlık - no hint
curious - Meraklı - no hint
constantly - sürekli - no hint
mystery - gizem - no hint
lifted - kaldırdı - no hint
leaves - yapraklar - no hint
skin - cilt - no hint
routine - rutin - no hint
rare - nadir - no hint
putting - koymak - no hint
aside - kenara - no hint
briefly - kısaca - no hint
spectrum - spektrum - no hint
selves - kendileri - no hint
sharp - keskin - no hint
considerable - önemli - no hint
commonly - yaygın olarak - no hint
seemingly - görünüşte - no hint
observing - gözlem - no hint
examine - muayene etmek - no hint
passive - pasif - no hint
ocean - okyanus - no hint
exploration - keşif - no hint
discovery - keşif - no hint
whilst - İken - no hint
peculiar - tuhaf - no hint
average - ortalama - no hint
duration - süresi - no hint
incredible - inanılmaz - no hint
planet - gezegen - no hint
majority - çoğunluk - no hint
require - gerek - no hint
eating - yemek yiyor - no hint
acts - eylemler - no hint
teaching - öğretim - no hint
endless - sonsuz - no hint
television - televizyon - no hint
streets - sokaklar - no hint
holds - tutar - no hint
opinion - fikir - no hint
bodily - bedensel - no hint
waste - atık - no hint
improve - geliştirmek - no hint
species - Türler - no hint
haven - cennet - no hint
functioning - işleyen - no hint
concerned - endişeli - no hint
healthy - sağlıklı - no hint
claim - İddia - no hint
content - içerik - no hint
analysis - analiz - no hint
taste - damak zevki - no hint
choice - tercih - no hint
actively - aktif olarak - no hint
absolute - mutlak - no hint
beauty - güzellik - no hint
previously - Önceden - no hint
fellow - dost - no hint
differences - farklılıklar - no hint
represent - temsil etmek - no hint
kitchen - mutfak - no hint
unlike - aksine - no hint
subjective - öznel - no hint
identical - özdeş - no hint
discussed - tartışıldı - no hint
brains - beyinler - no hint
conclusion - sonuç - no hint
critical - kritik - no hint
generated - oluşturulmuş - no hint
accompanied - eşlik eden - no hint
rarely - seyrek - no hint
hardly - zorlukla - no hint
attempting - teşebbüs - no hint
raise - yükseltmek - no hint
fantasy - fantezi - no hint
concepts - kavramlar - no hint
realistic - gerçekçi - no hint
utterly - tamamen - no hint
expected - beklenen - no hint
rapid - hızlı - no hint
movements - hareketler - no hint
occasionally - bazen - no hint
respond - cevap vermek - no hint
terror - terör - no hint
responses - tepkiler - no hint
neither - hiçbiri - no hint
distinct - farklı - no hint
variety - Çeşitlilik - no hint
removed - kaldırıldı - no hint
literally - kelimenin tam anlamıyla - no hint
intensity - yoğunluk - no hint
distant - uzak - no hint
kinds - türler - no hint
profound - derin - no hint
weight - ağırlık - no hint
unique - benzersiz - no hint
magical - büyülü - no hint
satisfied - memnun - no hint
proved - kanıtlanmış - no hint
surprise - sürpriz - no hint
onto - üstüne - no hint
immediate - hemen - no hint
difficulties - zorluklar - no hint
performed - gerçekleştirilen - no hint
respect - saygı - no hint
detailed - detaylı - no hint
suffer - acı çekmek - no hint
mechanism - mekanizma - no hint
catch - tutmak - no hint
thirty - otuz - no hint
equally - eşit - no hint
childhood - çocukluk - no hint
offer - teklif - no hint
skill - beceri - no hint
practitioners - uygulayıcılar - no hint
insight - içgörü - no hint
danger - Tehlike - no hint
formed - oluşturulan - no hint
private - özel - no hint
race - yarış - no hint
factor - faktör - no hint
processes - süreçler - no hint
address - adres - no hint
objective - amaç - no hint
facts - Gerçekler - no hint
surrounding - çevreleyen - no hint
writer - yazar - no hint
destination - hedef - no hint
lift - asansör - no hint
date - tarih - no hint
contains - içerir - no hint
attempted - teşebbüs - no hint
topics - konular - no hint
depth - derinlik - no hint
lifetime - ömür - no hint
prefer - tercih etmek - no hint
fresh - taze - no hint
sources - kaynaklar - no hint
designed - tasarlanmış - no hint
reference - referans - no hint
logical - mantıklı - no hint
helping - yardım ediyor - no hint
established - kurulmuş - no hint
evolution - evrim - no hint
built - inşa edilmiş - no hint
intelligent - akıllı - no hint
tools - araçlar - no hint
communicate - iletişim kurmak - no hint
culture - kültür - no hint
mysterious - gizemli - no hint
voices - sesler - no hint
humanity - insanlık - no hint
ages - yaşlar - no hint
occasion - fırsat - no hint
spontaneous - doğal - no hint
gods - tanrılar - no hint
significant - önemli - no hint
guidance - rehberlik - no hint
recorded - kaydedildi - no hint
remained - kaldı - no hint
recently - son günlerde - no hint
hidden - gizli - no hint
recent - son - no hint
description - açıklama - no hint
fourth - dördüncü - no hint
priest - rahip - no hint
deceased - merhum - no hint
visited - ziyaret - no hint
remarkable - dikkate değer - no hint
shown - gösterilen - no hint
holy - kutsal - no hint
characters - karakterler - no hint
opposite - karşısında - no hint
regularly - düzenli olarak - no hint
provided - sağlanan - no hint
achieving - başarmak - no hint
reader - okuyucu - no hint
value - değer - no hint
intended - amaçlanan - no hint
alert - uyarmak - no hint
starting - Başlangıç - no hint
thoroughly - iyice - no hint
seeking - arayan - no hint
popular - popüler - no hint
east - Doğu - no hint
china - Çin - no hint
intelligence - zeka - no hint
managed - yönetilen - no hint
regarding - ilgili - no hint
nights - geceler - no hint
records - kayıtları - no hint
fifteen - on beş - no hint
curiosity - merak - no hint
unfortunately - ne yazık ki - no hint
failed - başarısız oldu - no hint
famous - tanınmış - no hint
interpretation - yorumlama - no hint
directions - talimatlar - no hint
closely - yakından - no hint
suggests - Önerir - no hint
push - it - no hint
limits - limitler - no hint
purely - yalnızca - no hint
couple - çift - no hint
association - bağlantı - no hint
allowed - izin verildi - no hint
trigger - tetiklemek - no hint
induced - indüklenmiş - no hint
trip - gezi - no hint
slept - uyudu - no hint
mountains - dağlar - no hint
version - versiyon - no hint
researchers - araştırmacılar - no hint
terrible - korkunç - no hint
reflection - yansıma - no hint
basis - temel - no hint
capable - yetenekli - no hint
accurate - doğru - no hint
bringing - getirmek - no hint
twice - iki defa - no hint
transition - geçiş - no hint
describes - tanımlar - no hint
noted - not alınmış - no hint
indicate - belirtmek - no hint
enjoy - zevk almak - no hint
matters - önemli - no hint
papers - kağıtlar - no hint
altered - değişmiş - no hint
raising - yükselen - no hint
remains - kalıntılar - no hint
occasions - durumlar - no hint
train - tren - no hint
herself - kendini - no hint
houses - evler - no hint
stones - taşlar - no hint
sides - yanlar - no hint
correctly - doğru şekilde - no hint
solution - çözüm - no hint
ended - Bitti - no hint
sets - setleri - no hint
apart - ayrı - no hint
missing - eksik - no hint
determined - belirlenen - no hint
access - Giriş - no hint
machine - makine - no hint
save - kayıt etmek - no hint
careful - dikkatli - no hint
context - bağlam - no hint
brown - Kahverengi - no hint
turns - döner - no hint
angle - açı - no hint
degrees - derece - no hint
features - özellikleri - no hint
illusion - yanılsama - no hint
inducing - teşvik - no hint
observation - gözlem - no hint
acting - oyunculuk - no hint
institute - Enstitü - no hint
suggestions - öneriler - no hint
send - göndermek - no hint
signals - sinyaller - no hint
scientists - Bilim insanları - no hint
reasons - nedenleri - no hint
pulling - çekme - no hint
release - serbest bırakmak - no hint
mention - Anma - no hint
sphere - küre - no hint
addition - ilave - no hint
referred - sevk - no hint
central - merkezi - no hint
uses - kullanır - no hint
continues - devam ediyor - no hint
teachings - öğretiler - no hint
personally - Şahsen - no hint
produced - üretilmiş - no hint
computer - bilgisayar - no hint
guess - tahmin - no hint
compared - karşılaştırıldığında - no hint
signal - sinyal - no hint
genuine - hakiki - no hint
accepted - kabul edilmiş - no hint
occurring - meydana gelen - no hint
proof - kanıt - no hint
ease - kolaylaştırmak - no hint
offered - sunulan - no hint
allowing - izin vermek - no hint
extra - ekstra - no hint
visible - gözle görülür - no hint
switch - değiştirmek - no hint
lady - Hanım - no hint
ball - top - no hint
shortly - kısaca - no hint
shut - kapamak - no hint
greatest - En büyük - no hint
solar - solar - no hint
excited - uyarılmış - no hint
wearing - giyme - no hint
scenery - manzara - no hint
contained - içerilen - no hint
circumstances - koşullar - no hint
examples - örnekler - no hint
device - cihaz - no hint
command - komut - no hint
electrical - elektriksel - no hint
weak - güçsüz - no hint
stronger - Daha güçlü - no hint
alarm - alarm - no hint
conversation - konuşma - no hint
freedom - özgürlük - no hint
succeed - başarılı olmak - no hint
lines - çizgiler - no hint
agree - Katılıyorum - no hint
essential - önemli - no hint
apply - uygulamak - no hint
independent - bağımsız - no hint
void - geçersiz - no hint
seat - oturma yeri - no hint
huge - Kocaman - no hint
benefits - faydalar - no hint
physics - fizik - no hint
groups - grupları - no hint
applied - uygulamalı - no hint
helped - yardım etti - no hint
recommend - önermek - no hint
basics - temeller - no hint
bear - ayı - no hint
remembering - hatırlama - no hint
growing - büyüyen - no hint
vital - hayati - no hint
realms - krallıklar - no hint
cycles - döngüleri - no hint
stress - stres - no hint
purposes - amaçlar - no hint
viewpoint - bakış açısı - no hint
broken - kırık - no hint
characteristics - özellikleri - no hint
relatively - Nispeten - no hint
manual - Manuel - no hint
medicine - ilaç - no hint
confusion - bilinç bulanıklığı, konfüzyon - no hint
older - daha eski - no hint
drift - sürüklenme - no hint
external - dış - no hint
starts - başlar - no hint
follows - takip eder - no hint
functions - fonksiyonlar - no hint
confused - Şaşkın - no hint
gaze - gaz - no hint
blind - kör - no hint
necessarily - zorunlu olarak - no hint
corresponding - karşılık gelen - no hint
resting - dayanma - no hint
sequence - sıra - no hint
exact - tam - no hint
periods - dönemler - no hint
increases - artışlar - no hint
forgotten - unutulmuş - no hint
stick - Çubuk - no hint
latter - sonraki - no hint
refer - başvurmak - no hint
names - isimler - no hint
element - element - no hint
faint - baygın - no hint
tunnel - tünel - no hint
scenes - sahneler - no hint
rapidly - hızla - no hint
tend - Bakmak - no hint
build - inşa etmek - no hint
observer - gözlemci - no hint
loud - gürültülü - no hint
noises - sesler - no hint
ring - yüzük - no hint
factors - faktörler - no hint
snow - kar - no hint
accustomed - alışkın - no hint
safe - kasa - no hint
attack - saldırı - no hint
male - erkek - no hint
female - kadın - no hint
performing - performans - no hint
panic - panik - no hint
rule - kural - no hint
inches - inç - no hint
expectations - beklentiler - no hint
possibilities - olanaklar - no hint
chances - şans - no hint
signs - işaretler - no hint
nightmare - kâbus - no hint
unpleasant - hoş olmayan - no hint
contain - içerir - no hint
month - ay - no hint
wisdom - bilgelik - no hint
falls - düşme - no hint
procedure - prosedür - no hint
allows - izin verir - no hint
leading - lider - no hint
anywhere - herhangi bir yer - no hint
items - öğeler - no hint
lesson - ders - no hint
rushed - koştu - no hint
influences - etkiler - no hint
background - arka fon - no hint
firmly - sıkıca - no hint
spread - yayılmış - no hint
depending - bağlı - no hint
explanation - açıklama - no hint
habits - alışkanlıklar - no hint
individuals - bireyler - no hint
moves - hareketler - no hint
reaching - ulaşma - no hint
balance - denge - no hint
operating - işletme - no hint
sufficient - yeterli - no hint
brings - getiriyor - no hint
trick - hile - no hint
principle - prensip - no hint
instructions - Talimatlar - no hint
achieved - elde edildi - no hint
setting - ayar - no hint
elsewhere - başka yerde - no hint
limitations - sınırlamalar - no hint
forced - zorunlu - no hint
dealing - ticaret - no hint
slight - hafif - no hint
rush - acele - no hint
stimulation - uyarım - no hint
loss - kayıp - no hint
smoke - Sigara içmek - no hint
everyday - Her gün - no hint
fail - başarısız - no hint
desired - İstenen - no hint
secondary - ikincil - no hint
benefit - yarar - no hint
fallen - düşmüş - no hint
spot - yer - no hint
ideal - ideal - no hint
successfully - başarıyla - no hint
fish - balık - no hint
firm - sağlam - no hint
relative - akraba - no hint
reminded - hatırlattı - no hint
partially - kısmen - no hint
efforts - çabalar - no hint
empty - boş - no hint
struggle - mücadele etmek - no hint
constant - sabit - no hint
serve - servis - no hint
growth - büyüme - no hint
store - mağaza - no hint
awoke - uyandırmak - no hint
gold - altın - no hint
continuing - devam ediyor - no hint
discussion - tartışma - no hint
helpful - faydalı - no hint
fixed - sabit - no hint
route - rota - no hint
fade - solmak - no hint
leads - yol açar - no hint
remind - hatırlatmak - no hint
closer - daha yakın - no hint
pushed - itti - no hint
model - model - no hint
advantage - avantaj - no hint
screen - ekran - no hint
attached - ekli - no hint
obviously - açıkça - no hint
stable - kararlı - no hint
issues - sorunlar - no hint
rules - kurallar - no hint
laws - kanunlar - no hint
gravity - Yerçekimi - no hint
extreme - aşırı - no hint
afternoon - öğleden sonra - no hint
count - Miktar - no hint
surprised - şaşırmış - no hint
typical - tipik - no hint
garden - Bahçe - no hint
nearby - yakınlarda - no hint
birds - kuşlar - no hint
beat - dövmek - no hint
lessons - dersler - no hint
phrase - ifade - no hint
stuck - sıkışmış - no hint
touched - dokundu - no hint
universal - evrensel - no hint
grow - büyümek - no hint
stories - hikayeler - no hint
fairy - peri - no hint
possess - sahip olmak - no hint
passage - geçit - no hint
bridge - köprü - no hint
depends - bağlı olmak - no hint
worry - endişelenmek - no hint
barrier - bariyer - no hint
trained - eğitimli - no hint
raised - yükseltilmiş - no hint
properly - uygun şekilde - no hint
everywhere - her yerde - no hint
showing - gösteren - no hint
assume - varsaymak - no hint
seriously - ciddi anlamda - no hint
examined - incelendi - no hint
suitable - uygun - no hint
wear - giyinmek - no hint
card - kart - no hint
brother - erkek kardeş - no hint
upwards - yukarı - no hint
willing - istekli - no hint
wise - bilge - no hint
confidence - güven - no hint
dangerous - tehlikeli - no hint
abstract - Öz - no hint
numbers - sayılar - no hint
flowing - akan - no hint
carrying - taşıma - no hint
focusing - odaklanma - no hint
nonphysical - fiziksel olmayan - no hint
breathe - nefes almak - no hint
imaginary - hayali - no hint
requires - gerektirir - no hint
quick - hızlı - no hint
arise - ortaya çıkmak - no hint
suggested - önerildi - no hint
causing - neden olan - no hint
observed - gözlemlendi - no hint
jump - atlama - no hint
trust - güven - no hint
reflect - yansıtmak - no hint
faster - Daha hızlı - no hint
prayer - namaz - no hint
cure - Çare - no hint
tasks - görevler - no hint
extent - kapsam - no hint
meditate - meditasyon yapmak - no hint
chosen - seçilmiş - no hint
initial - ilk - no hint
pieces - adet - no hint
size - to you - no hint
principles - prensipler - no hint
wild - vahşi - no hint
spontaneously - kendiliğinden - no hint
speaking - konuşuyorum - no hint
excitement - heyecan - no hint
draw - çizmek - no hint
touching - dokunma - no hint
calling - arama - no hint
studying - ders çalışıyor - no hint
pointed - işaretlendi - no hint
substance - madde - no hint
highest - en yüksek - no hint
drink - İçmek - no hint
affect - etkilemek - no hint
valuable - değerli - no hint
proper - uygun - no hint
simultaneously - eşzamanlı - no hint
lucidly - açıkça - no hint
corner - köşe - no hint
showed - gösterdi - no hint
indicates - gösterir - no hint
roof - çatı - no hint
literature - Edebiyat - no hint
philosophy - Felsefe - no hint
surely - kesinlikle - no hint
meal - yemek - no hint
butter - Tereyağı - no hint
harm - zarar - no hint
organs - organlar - no hint
medium - orta - no hint
application - uygulama - no hint
definite - kesin - no hint
awakened - uyanmış - no hint
calls - aramalar - no hint
gain - kazanç - no hint
answered - cevapladı - no hint
flowers - Çiçekler - no hint
jumped - atladı - no hint
flame - alev - no hint
escape - kaçış - no hint
comfort - konfor - no hint
wants - ister - no hint
lake - göl - no hint
laboratory - laboratuar - no hint
express - ekspres - no hint
silent - sessiz - no hint
settled - yerleşik - no hint
ends - biter - no hint
finished - bitmiş - no hint
hearing - işitme - no hint
flat - düz - no hint
imagined - hayal - no hint
finger - parmak - no hint
regard - saygı - no hint
repeated - tekrarlanan - no hint
mere - Daha - no hint
star - star - no hint
drop - düşürmek - no hint
illness - hastalık - no hint
treatment - tedavi - no hint
creates - oluşturur - no hint
losing - kaybetmek - no hint
discipline - disiplin - no hint
inhabitants - sakinler - no hint
statement - Beyan - no hint
busy - meşgul - no hint
station - istasyon - no hint
mouth - ağız - no hint
hurt - canını yakmak - no hint
character - karakter - no hint
caught - yakalandı - no hint
instant - anında - no hint
capacity - kapasite - no hint
dimensions - boyutları - no hint
existing - mevcut - no hint
millions - milyonlar - no hint
psyche - ruh - no hint
anyway - neyse - no hint
request - istek - no hint
drawn - çizilmiş - no hint
perceptions - algılar - no hint
manifest - belirgin - no hint
facing - karşı karşıya - no hint
clothing - Giyim - no hint
watched - izledi - no hint
circle - daire - no hint
dropped - düştü - no hint
spinning - eğirme - no hint
faded - solmuş - no hint
ears - kulaklar - no hint
grew - büyüdü - no hint
blackness - siyahlık - no hint
centuries - yüzyıllar - no hint
worse - daha da kötüsü - no hint
bottom - alt - no hint
thin - ince - no hint
wondering - merak ediyor - no hint
pages - sayfaları - no hint
charge - şarj etmek - no hint
finds - bulur - no hint
oneself - kendini - no hint
reflected - yansıyan - no hint
happiness - mutluluk - no hint
attitude - tavır - no hint
electricity - elektrik - no hint
telephone - telefon - no hint
outer - dış - no hint
electric - elektrik - no hint
listening - dinleme - no hint
smell - koku - no hint
affected - etkilenmiş - no hint
gained - kazanılmış - no hint
structures - yapılar - no hint
episode - bölüm - no hint
enable - etkinleştirme - no hint
roll - rulo - no hint
mass - kitle - no hint
approached - yaklaştı - no hint
speech - konuşma - no hint
anxiety - kaygı - no hint
climbing - Tırmanmak - no hint
band - grup - no hint
composed - bestelenmiş - no hint
involves - içerir - no hint
crystal - kristal - no hint
mystical - mistik - no hint
suppose - varsaymak - no hint
library - kütüphane - no hint
park - park - no hint
expression - ifade - no hint
traditional - geleneksel - no hint
earthly - dünyevi - no hint
angels - melekler - no hint
hole - delik - no hint
identify - belirlemek - no hint
wondered - merak - no hint
fields - alanlar - no hint
views - Görüntüleme - no hint
temporary - geçici - no hint
religions - dinler - no hint
invisible - görünmez - no hint
stream - Akış - no hint
gentle - nazik - no hint
attain - ulaşmak - no hint
traditions - gelenekler - no hint
throat - boğaz - no hint
stomach - mide - no hint
studied - okudu - no hint
messages - mesajlar - no hint
telepathy - telepati - no hint
immense - engin - no hint
basically - temelde - no hint
rolling - yuvarlanma - no hint
drive - sürücü - no hint
rising - yükselen - no hint
dust - toz - no hint
tells - anlatır - no hint
hall - salon - no hint
controlled - kontrollü - no hint
souls - ruhlar - no hint
introduction - Giriş - no hint
hill - Tepe - no hint
gate - kapı - no hint
lamas - en çok - no hint
hanging - asılı - no hint
weird - tuhaf - no hint
super - Süper - no hint
realizing - farkına varma - no hint
hypnosis - hipnoz - no hint
theories - teoriler - no hint
