misspell -  . m. i. s. s. p. e. l. l.  - write the letters of incorrectly
dissatisfy - d. i. s. s. a. t. i. s. f. y.  - fail to please or meet expectations
dispensable - d. i. s. p. e. n. s. a. b. l. e.  - capable of being eliminated or done without
questionnaire - q. u. e. s. t. i. o. n. n. a. i. r. e.  - a form with a set of queries to gain statistical information
neutron - n. e. u. t. r. o. n.  - a subatomic particle with zero charge
possessive - p. o. s. s. e. s. s. i. vee. e.  - serving to express or indicate the act of having
Weird - W. e. i. r. d.  - fate personified; any one of the three Weird Sisters
fluorescent - f. l. u. o. r. e. s. c. e. n. t.  - emitting light during exposure to external radiant energy
believable - b. e. l. i. e. vee. a. b. l. e.  - capable of being accepted as true
harass - h. a. r. a. s. s.  - annoy continually or chronically
idiosyncrasy - i. d. i. o. s. y. n. c. r. a. s. y.  - a behavioral attribute peculiar to an individual
panicky - p. a. n. i. c. k. y.  - thrown into a state of intense fear or desperation
realistically - r. e. a. l. i. s. t. i. c. a. l. l. y.  - in a realistic manner
secede - s. e. c. e. d. e.  - withdraw from an organization or polity
quandary - q. u. a. n. d. a. r. y.  - state of uncertainty in a choice between unfavorable options
exaggerate - e. x. a. g. g. e. r. a. t. e.  - enlarge beyond bounds or the truth
fascinate - f. a. s. c. i. n. a. t. e.  - attract; cause to be enamored
mosquito - m. o. s. q. u. i. t. o.  - two-winged insect that sucks the blood of humans and animals
hesitancy - h. e. s. i. t. a. n. c. y.  - a feeling of diffidence and indecision about doing something
roommate - r. o. o. m. m. a. t. e.  - an associate who shares a room with you
guerrilla - g. u. e. r. r. i. l. l. a.  - a member of an irregular army that fights a stronger force
manageable - m. a. n. a. g. e. a. b. l. e.  - capable of being controlled
rhythmical - r. h. y. t. h. m. i. c. a. l.  - recurring with measured regularity
fallacious - f. a. l. l. a. c. i. o. u. s.  - containing or based on incorrect reasoning
fulfill - f. u. l. f. i. l. l.  - meet a want or need
pronunciation - p. r. o. n. u. n. c. i. a. t. i. o. n.  - the manner in which someone utters a word
ideally - i. d. e. a. l. l. y.  - in an ideal manner
aggravate - a. g. g. r. a. vee. a. t. e.  - make worse
sacrilegious - s. a. c. r. i. l. e. g. i. o. u. s.  - grossly irreverent toward what is considered holy
intercede - i. n. t. e. r. c. e. d. e.  - act between parties with a view to reconciling differences
supersede - s. u. p. e. r. s. e. d. e.  - take the place or move into the position of
quiz - q. u. i. z.  - an examination consisting of a few short questions
stubbornness - s. t. u. b. b. o. r. n. n. e. s. s.  - resolute adherence to your own ideas or desires
soliloquy - s. o. l. i. l. o. q. u. y.  - speech you make to yourself
allege - a. l. l. e. g. e.  - report or maintain
acclaim - a. c. c. l. a. i. m.  - enthusiastic approval
equip - e. q. u. i. p.  - provide with, usually for a specific purpose
heinous - h. e. i. n. o. u. s.  - extremely wicked or deeply criminal
refrigerator - r. e. f. r. i. g. e. r. a. t. o. r.  - white goods in which food can be stored at low temperatures
liaison - l. i. a. i. s. o. n.  - a means of communication between groups
lenient - l. e. n. i. e. n. t.  - inclined to be permissive or indulgent
quarantine - q. u. a. r. a. n. t. i. n. e.  - isolation to prevent the spread of infectious disease
omit - o. m. i. t.  - leave undone or leave out
counselor - c. o. u. n. s. e. l. o. r.  - someone who gives advice about problems
scary - s. c. a. r. y.  - provoking fear or terror
recede - r. e. c. e. d. e.  - pull back or move away or backward
permissible - p. e. r. m. i. s. s. i. b. l. e.  - acceptable, especially as according to rule
embarrass - e. m. b. a. r. r. a. s. s.  - cause to feel self-conscious
hypocrisy - h. y. p. o. c. r. i. s. y.  - pretending to have qualities or beliefs that you do not have
souvenir - s. o. u. vee. e. n. i. r.  - something of sentimental value
simile - s. i. m. i. l. e.  - a figure of speech expressing a resemblance between things
exuberance - e. x. u. b. e. r. a. n. c. e.  - joyful enthusiasm
symmetrical - s. y. m. m. e. t. r. i. c. a. l.  - exhibiting equivalence or correspondence among constituents
skiing - s. k. i. i. n. g.  - a sport in which participants must travel on skis
millionaire - m. i. l. l. i. o. n. a. i. r. e.  - a person whose material wealth is valued at more than a million dollars
maneuver - m. a. n. e. u. vee. e. r.  - a military training exercise
Hero - H. e. r. o.  - (Greek mythology) priestess of Aphrodite who killed herself when her lover Leander drowned while trying to swim the Hellespont to see her
criticize - c. r. i. t. i. c. i. z. e.  - point out real or perceived flaws
reminiscence - r. e. m. i. n. i. s. c. e. n. c. e.  - a mental impression retained and recalled from the past
portray - p. o. r. t. r. a. y.  - represent abstractly, for example in a painting
synonymous - s. y. n. o. n. y. m. o. u. s.  - meaning the same or nearly the same
fallacy - f. a. l. l. a. c. y.  - a misconception resulting from incorrect reasoning
curriculum - c. u. r. r. i. c. u. l. u. m.  - an integrated course of academic studies
accumulate - a. c. c. u. m. u. l. a. t. e.  - get or gather together
sophomore - s. o. p. h. o. m. o. r. e.  - a second-year undergraduate
feasible - f. e. a. s. i. b. l. e.  - capable of being done with means at hand
overrun - o. vee. e. r. r. u. n.  - seize the position of and defeat
rhythm - r. h. y. t. h. m.  - an interval during which a recurring sequence occurs
fundamentally - f. u. n. d. a. m. e. n. t. a. l. l. y.  - in essence; at bottom or by one's (or its) very nature
millennium - m. i. l. l. e. n. n. i. u. m.  - a span of 1000 years
disappoint - d. i. s. a. p. p. o. i. n. t.  - fail to meet the hopes or expectations of
humorous - h. u. m. o. r. o. u. s.  - characterized by the power to evoke laughter
courteous - c. o. u. r. t. e. o. u. s.  - characterized by politeness and gracious good manners
financially - f. i. n. a. n. c. i. a. l. l. y.  - from a financial point of view
receipt - r. e. c. e. i. p. t.  - the act of receiving
hindrance - h. i. n. d. r. a. n. c. e.  - any obstruction that impedes or is burdensome
hypocrite - h. y. p. o. c. r. i. t. e.  - a person who professes beliefs that he or she does not hold
fictitious - f. i. c. t. i. t. i. o. u. s.  - formed or conceived by the imagination
implement - i. m. p. l. e. m. e. n. t.  - a piece of equipment or a tool used for a specific purpose
irrelevant - i. r. r. e. l. e. vee. a. n. t.  - having no bearing on or connection with the subject at issue
rheumatism - r. h. e. u. m. a. t. i. s. m.  - any painful disorder of the joints or muscles
reservoir - r. e. s. e. r. vee. o. i. r.  - lake used to store water for community use
persistence - p. e. r. s. i. s. t. e. n. c. e.  - continuing or repeating behavior
Village - vee. i. l. l. a. g. e.  - a mainly residential district of Manhattan
schedule - s. c. h. e. d. u. l. e.  - a list of times at which things are planned to occur
guarantee - g. u. a. r. a. n. t. e. e.  - an unconditional commitment that something will happen
exhaust - e. x. h. a. u. s. t.  - wear out completely
achievement - a. c. h. i. e. vee. e. m. e. n. t.  - the action of accomplishing something
peaceable - p. e. a. c. e. a. b. l. e.  - inclined or disposed to peace
vigilant - vee. i. g. i. l. a. n. t.  - carefully observant or attentive
Independence - I. n. d. e. p. e. n. d. e. n. c. e.  - a city in western Missouri
maintenance - m. a. i. n. t. e. n. a. n. c. e.  - activity involved in keeping something in good working order
forfeit - f. o. r. f. e. i. t.  - lose the right to or lose by some error, offense, or crime
deceive - d. e. c. e. i. vee. e.  - cause someone to believe an untruth
vacuum - vee. a. c. u. u. m.  - an empty area or space
drunkenness - d. r. u. n. k. e. n. n. e. s. s.  - a temporary state resulting from excessive consumption of alcohol
apologize - a. p. o. l. o. g. i. z. e.  - acknowledge faults or shortcomings or failing
likelihood - l. i. k. e. l. i. h. o. o. d.  - the probability of a specified outcome
omission - o. m. i. s. s. i. o. n.  - leaving out or passing over something
tangible - t. a. n. g. i. b. l. e.  - perceptible by the senses, especially the sense of touch
foresee - f. o. r. e. s. e. e.  - realize beforehand
nuisance - n. u. i. s. a. n. c. e.  - anything that disturbs, endangers life, or is offensive
prescription - p. r. e. s. c. r. i. p. t. i. o. n.  - the action of issuing authoritative rules or directions
outrageous - o. u. t. r. a. g. e. o. u. s.  - greatly exceeding bounds of reason or moderation
ski - s. k. i.  - narrow wood or metal or plastic runners used in pairs for gliding over snow
optimism - o. p. t. i. m. i. s. m.  - the hopeful feeling that all is going to turn out well
bicycle - b. i. c. y. c. l. e.  - a vehicle that has two wheels and is moved by foot pedals
incidentally - i. n. c. i. d. e. n. t. a. l. l. y.  - by the way (used to introduce a new topic)
restaurant - r. e. s. t. a. u. r. a. n. t.  - a building where people go to eat
picnic - p. i. c. n. i. c.  - any informal meal eaten outside or on an excursion
dilemma - d. i. l. e. m. m. a.  - state of uncertainty in a choice between unfavorable options
defendant - d. e. f. e. n. d. a. n. t.  - someone against whom an action is brought in a court of law
accommodate - a. c. c. o. m. m. o. d. a. t. e.  - have room for; hold without crowding
dissatisfied - d. i. s. s. a. t. i. s. f. i. e. d.  - in a state of sulky dissatisfaction
pavilion - p. a. vee. i. l. i. o. n.  - a large and often sumptuous tent
longitude - l. o. n. g. i. t. u. d. e.  - the angular distance from the prime meridian at Greenwich
noticeable - n. o. t. i. c. e. a. b. l. e.  - capable of being detected
prevalent - p. r. e. vee. a. l. e. n. t.  - most frequent or common
strenuous - s. t. r. e. n. u. o. u. s.  - taxing to the utmost; testing powers of endurance
unnecessary - u. n. n. e. c. e. s. s. a. r. y.  - not needed
license - l. i. c. e. n. s. e.  - a legal document giving official permission to do something
unanimous - u. n. a. n. i. m. o. u. s.  - in complete agreement
syllable - s. y. l. l. a. b. l. e.  - a unit of spoken language larger than a phoneme
perseverance - p. e. r. s. e. vee. e. r. a. n. c. e.  - the act of persisting
surround - s. u. r. r. o. u. n. d.  - extend on all sides of simultaneously; encircle
susceptible - s. u. s. c. e. p. t. i. b. l. e.  - yielding readily to or capable of
interrupt - i. n. t. e. r. r. u. p. t.  - make a break in
ninety - n. i. n. e. t. y.  - the cardinal number that is the product of ten and nine
accessible - a. c. c. e. s. s. i. b. l. e.  - capable of being reached
missile - m. i. s. s. i. l. e.  - a weapon that is forcibly thrown or projected at a target
eligible - e. l. i. g. i. b. l. e.  - qualified for or allowed or worthy of being chosen
category - c. a. t. e. g. o. r. y.  - a general concept that marks divisions or coordinations
assassination - a. s. s. a. s. s. i. n. a. t. i. o. n.  - murder of a public figure by surprise attack
suppress - s. u. p. p. r. e. s. s.  - put down by force or authority
grievous - g. r. i. e. vee. o. u. s.  - causing or marked by grief or anguish
potato - p. o. t. a. t. o.  - an edible tuber native to South America
spontaneous - s. p. o. n. t. a. n. e. o. u. s.  - said or done without having been planned in advance
leisure - l. e. i. s. u. r. e.  - time available for ease and relaxation
mischievous - m. i. s. c. h. i. e. vee. o. u. s.  - naughtily or annoyingly playful
commitment - c. o. m. m. i. t. m. e. n. t.  - the act of binding yourself to a course of action
accidentally - a. c. c. i. d. e. n. t. a. l. l. y.  - without intention; in an unintentional manner
propaganda - p. r. o. p. a. g. a. n. d. a.  - information that is spread to promote some cause
forcibly - f. o. r. c. i. b. l. y.  - in a forcible manner
specifically - s. p. e. c. i. f. i. c. a. l. l. y.  - in distinction from others
technique - t. e. c. h. n. i. q. u. e.  - a practical method or art applied to some particular task
mathematics - m. a. t. h. e. m. a. t. i. c. s.  - a science dealing with the logic of quantity and arrangement
pronounce - p. r. o. n. o. u. n. c. e.  - speak or utter in a certain way
miniature - m. i. n. i. a. t. u. r. e.  - being on a very small scale
ecstasy - e. c. s. t. a. s. y.  - a state of elated bliss
pilgrimage - p. i. l. g. r. i. m. a. g. e.  - a journey to a sacred place
ordinarily - o. r. d. i. n. a. r. i. l. y.  - under normal conditions
advertisement - a. d. vee. e. r. t. i. s. e. m. e. n. t.  - a public promotion of some product or service
twelfth - t. w. e. l. f. t. h.  - position 12 in a countable series of things
accommodation - a. c. c. o. m. m. o. d. a. t. i. o. n.  - making or becoming suitable; adjusting to circumstances
privilege - p. r. i. vee. i. l. e. g. e.  - a special advantage or benefit not enjoyed by all
usage - u. s. a. g. e.  - the act of employing
disappearance - d. i. s. a. p. p. e. a. r. a. n. c. e.  - the event of passing out of sight
condemn - c. o. n. d. e. m. n.  - express strong disapproval of
subordinate - s. u. b. o. r. d. i. n. a. t. e.  - an assistant subject to the authority or control of another
penetrate - p. e. n. e. t. r. a. t. e.  - pass into or through, often by overcoming resistance
pitiful - p. i. t. i. f. u. l.  - deserving or inciting compassion
satellite - s. a. t. e. l. l. i. t. e.  - any celestial body orbiting around a planet or star
discipline - d. i. s. c. i. p. l. i. n. e.  - a system of rules of conduct or method of practice
gauge - g. a. u. g. e.  - an instrument for measuring and indicating a quantity
exceed - e. x. c. e. e. d.  - be or do something to a greater degree
loneliness - l. o. n. e. l. i. n. e. s. s.  - sadness resulting from being forsaken or abandoned
psychology - p. s. y. c. h. o. l. o. g. y.  - the science of mental life
hoarse - h. o. a. r. s. e.  - deep and harsh sounding as if from shouting or illness
dominant - d. o. m. i. n. a. n. t.  - most frequent or common
sponsor - s. p. o. n. s. o. r.  - an advocate who presents a person
relevant - r. e. l. e. vee. a. n. t.  - having a bearing on or connection with the subject at issue
repetition - r. e. p. e. t. i. t. i. o. n.  - the act of doing or performing again
influential - i. n. f. l. u. e. n. t. i. a. l.  - having or exercising power
calendar - c. a. l. e. n. d. a. r.  - a system of timekeeping that defines divisions of the year
oppression - o. p. p. r. e. s. s. i. o. n.  - the act of subjugating by cruelty
disastrous - d. i. s. a. s. t. r. o. u. s.  - having extremely unfortunate or dire consequences
obstacle - o. b. s. t. a. c. l. e.  - something that stands in the way and must be surmounted
column - c. o. l. u. m. n.  - a line of units following one after another
coolly - c. o. o. l. l. y.  - in a composed and unconcerned manner
nowadays - n. o. w. a. d. a. y. s.  - in these times
grammar - g. r. a. m. m. a. r.  - the branch of linguistics that deals with sentence structure
amateur - a. m. a. t. e. u. r.  - someone who pursues a study or sport as a pastime
imaginary - i. m. a. g. i. n. a. r. y.  - not based on fact; unreal
procedure - p. r. o. c. e. d. u. r. e.  - a particular course of action intended to achieve a result
succeed - s. u. c. c. e. e. d.  - attain success or reach a desired goal
laboratory - l. a. b. o. r. a. t. o. r. y.  - a workplace for the conduct of scientific research
statistics - s. t. a. t. i. s. t. i. c. s.  - a branch of mathematics concerned with quantitative data
competent - c. o. m. p. e. t. e. n. t.  - properly or sufficiently qualified, capable, or efficient
indispensable - i. n. d. i. s. p. e. n. s. a. b. l. e.  - essential
equipped - e. q. u. i. p. p. e. d.  - provided with whatever is necessary for a purpose
muscle - m. u. s. c. l. e.  - animal tissue consisting predominantly of contractile cells
villain - vee. i. l. l. a. i. n.  - someone who does evil deliberately
sincerely - s. i. n. c. e. r. e. l. y.  - without pretense
dining - d. i. n. i. n. g.  - the act of eating dinner
irresistible - i. r. r. e. s. i. s. t. i. b. l. e.  - impossible to withstand; overpowering
preference - p. r. e. f. e. r. e. n. c. e.  - the right or chance to choose
mortgage - m. o. r. t. g. a. g. e.  - a conveyance of property as security for repaying a loan
interference - i. n. t. e. r. f. e. r. e. n. c. e.  - the act of hindering or obstructing or impeding
occurrence - o. c. c. u. r. r. e. n. c. e.  - an instance of something happening
ninth - n. i. n. t. h.  - position nine in a countable series of things
consistent - c. o. n. s. i. s. t. e. n. t.  - the same throughout in structure or composition
efficiency - e. f. f. i. c. i. e. n. c. y.  - skillfulness in avoiding wasted time and effort
tyranny - t. y. r. a. n. n. y.  - government in which the ruler is an absolute dictator
comparative - c. o. m. p. a. r. a. t. i. vee. e.  - involving the examination of similarities and differences
excellence - e. x. c. e. l. l. e. n. c. e.  - possessing good qualities in high degree
opponent - o. p. p. o. n. e. n. t.  - someone who offers resistance
guidance - g. u. i. d. a. n. c. e.  - the act of showing the way
cigarette - c. i. g. a. r. e. t. t. e.  - finely ground tobacco wrapped in paper; for smoking
descend - d. e. s. c. e. n. d.  - move downward and lower, but not necessarily all the way
scenery - s. c. e. n. e. r. y.  - the appearance of a place
transfer - t. r. a. n. s. f. e. r.  - move from one place to another
recommend - r. e. c. o. m. m. e. n. d.  - express a good opinion of
legitimate - l. e. g. i. t. i. m. a. t. e.  - in accordance with accepted standards or principles
specimen - s. p. e. c. i. m. e. n.  - a bit of tissue or fluid taken for diagnostic purposes
dine - d. i. n. e.  - have supper; eat dinner
continuous - c. o. n. t. i. n. u. o. u. s.  - moving in time or space without interruption
thorough - t. h. o. r. o. u. g. h.  - painstakingly careful and accurate
appreciation - a. p. p. r. e. c. i. a. t. i. o. n.  - understanding of the nature or meaning of something
judicial - j. u. d. i. c. i. a. l.  - expressing careful judgment
eighth - e. i. g. h. t. h.  - position eight in a countable series of things
murmur - m. u. r. m. u. r.  - a low continuous indistinct sound
remembrance - r. e. m. e. m. b. r. a. n. c. e.  - the ability to recall past occurrences
relieve - r. e. l. i. e. vee. e.  - free from a burden, evil, or distress
controlled - c. o. n. t. r. o. l. l. e. d.  - restrained or managed or kept within certain bounds
Wednesday - W. e. d. n. e. s. d. a. y.  - the fourth day of the week; the third working day
resemblance - r. e. s. e. m. b. l. a. n. c. e.  - similarity in appearance or external or superficial details
incredible - i. n. c. r. e. d. i. b. l. e.  - extraordinarily good or great
warrant - w. a. r. r. a. n. t.  - formal and explicit approval
suspicious - s. u. s. p. i. c. i. o. u. s.  - openly distrustful and unwilling to confide
tournament - t. o. u. r. n. a. m. e. n. t.  - a competition in which contestants play a series of games
definitely - d. e. f. i. n. i. t. e. l. y.  - without question and beyond doubt
prejudice - p. r. e. j. u. d. i. c. e.  - a partiality preventing objective consideration of an issue
alleged - a. l. l. e. g. e. d.  - doubtful or suspect
shepherd - s. h. e. p. h. e. r. d.  - someone who keeps sheep together in a flock
publicly - p. u. b. l. i. c. l. y.  - in a manner accessible to or observable by the public
accomplish - a. c. c. o. m. p. l. i. s. h.  - achieve with effort
independent - i. n. d. e. p. e. n. d. e. n. t.  - free from external control and constraint
technical - t. e. c. h. n. i. c. a. l.  - of or relating to aptitude in a practical skill
shine - s. h. i. n. e.  - emit light; be bright, as of the sun or a light
equivalent - e. q. u. i. vee. a. l. e. n. t.  - being essentially comparable to something
dependent - d. e. p. e. n. d. e. n. t.  - a person who relies on another person for support
introduce - i. n. t. r. o. d. u. c. e.  - bring something new to an environment
abundance - a. b. u. n. d. a. n. c. e.  - the property of a more than adequate quantity or supply
salary - s. a. l. a. r. y.  - fixed payment for services
courtesy - c. o. u. r. t. e. s. y.  - a considerate and respectful manner
neighbor - n. e. i. g. h. b. o. r.  - a person who lives near another
strategy - s. t. r. a. t. e. g. y.  - an elaborate and systematic plan of action
subtle - s. u. b. t. l. e.  - difficult to detect or grasp by the mind or analyze
conceive - c. o. n. c. e. i. vee. e.  - have the idea for
absence - a. b. s. e. n. c. e.  - the state of being not present
seize - s. e. i. z. e.  - take hold of; grab
refer - r. e. f. e. r.  - make a remark that calls attention to
appetite - a. p. p. e. t. i. t. e.  - a feeling of craving something
tomorrow - t. o. m. o. r. r. o. w.  - the day after today
handkerchief - h. a. n. d. k. e. r. c. h. i. e. f.  - a square piece of cloth used for wiping the eyes or nose
desirable - d. e. s. i. r. a. b. l. e.  - worth having or seeking or achieving
planning - p. l. a. n. n. i. n. g.  - an act of formulating a program for a course of action
parallel - p. a. r. a. l. l. e. l.  - being everywhere equidistant and not intersecting
jealousy - j. e. a. l. o. u. s. y.  - a feeling of envy, especially of a rival
height - h. e. i. g. h. t.  - distance from the base of something to its top
pursue - p. u. r. s. u. e.  - follow in an effort to capture
convenient - c. o. n. vee. e. n. i. e. n. t.  - suited to your comfort or purpose or needs
vengeance - vee. e. n. g. e. a. n. c. e.  - harming someone in retaliation for something they have done
luxury - l. u. x. u. r. y.  - something that is an indulgence rather than a necessity
climb - c. l. i. m. b.  - go up or advance
correspondence - c. o. r. r. e. s. p. o. n. d. e. n. c. e.  - an attribute of a shape or relation
happily - h. a. p. p. i. l. y.  - in a joyous manner
lightning - l. i. g. h. t. n. i. n. g.  - flash of light from an electric discharge in the atmosphere
develop - d. e. vee. e. l. o. p.  - progress or evolve through a process of natural growth
obedience - o. b. e. d. i. e. n. c. e.  - the trait of being willing to follow commands or guidance
primitive - p. r. i. m. i. t. i. vee. e.  - characteristic of an earlier ancestral type
temperature - t. e. m. p. e. r. a. t. u. r. e.  - the degree of hotness or coldness of a body or environment
sergeant - s. e. r. g. e. a. n. t.  - a noncommissioned officer ranking above a corporal
preparation - p. r. e. p. a. r. a. t. i. o. n.  - setting in order in advance some act or purpose
perceive - p. e. r. c. e. i. vee. e.  - become aware of through the senses
undoubtedly - u. n. d. o. u. b. t. e. d. l. y.  - certainly
inevitable - i. n. e. vee. i. t. a. b. l. e.  - incapable of being avoided or prevented
insurance - i. n. s. u. r. a. n. c. e.  - protection against future loss
prominent - p. r. o. m. i. n. e. n. t.  - conspicuous in position or importance
experiment - e. x. p. e. r. i. m. e. n. t.  - the act of conducting a controlled test or investigation
narrative - n. a. r. r. a. t. i. vee. e.  - an account that tells the particulars of an act or event
physician - p. h. y. s. i. c. i. a. n.  - a licensed medical practitioner
preferred - p. r. e. f. e. r. r. e. d.  - more desirable than another
succession - s. u. c. c. e. s. s. i. o. n.  - the action or process of taking over an office or position
address - a. d. d. r. e. s. s.  - the place where a person or organization can be found
recognize - r. e. c. o. g. n. i. z. e.  - perceive to be something or something you can identify
prefer - p. r. e. f. e. r.  - like better; value more highly
tendency - t. e. n. d. e. n. c. y.  - an inclination to do something
occur - o. c. c. u. r.  - come to pass
representative - r. e. p. r. e. s. e. n. t. a. t. i. vee. e.  - serving to typify
realize - r. e. a. l. i. z. e.  - be fully aware or cognizant of
practically - p. r. a. c. t. i. c. a. l. l. y.  - in a manner concerned with actual use
wherever - w. h. e. r. e. vee. e. r.  - where in the world
receive - r. e. c. e. i. vee. e.  - get something; come into possession of
resistance - r. e. s. i. s. t. a. n. c. e.  - any mechanical force that tends to slow or oppose motion
medicine - m. e. d. i. c. i. n. e.  - the profession devoted to alleviating diseases and injuries
ignorance - i. g. n. o. r. a. n. c. e.  - the lack of knowledge or education
permit - p. e. r. m. i. t.  - allow the presence of or allow without opposing
favorite - f. a. vee. o. r. i. t. e.  - preferred above all others and treated with partiality
maintain - m. a. i. n. t. a. i. n.  - keep in a certain state, position, or activity
permanent - p. e. r. m. a. n. e. n. t.  - continuing or enduring without marked change in status
expense - e. x. p. e. n. s. e.  - a financial burden; money that must be paid out
possess - p. o. s. s. e. s. s.  - have ownership of
desperate - d. e. s. p. e. r. a. t. e.  - a person who is frightened and in need of help
magazine - m. a. g. a. z. i. n. e.  - a periodic publication containing articles and pictures
proceed - p. r. o. c. e. e. d.  - move ahead; travel onward in time or space
consciousness - c. o. n. s. c. i. o. u. s. n. e. s. s.  - an alert cognitive state in which you are aware of yourself
shining - s. h. i. n. i. n. g.  - the work of making something smooth and shiny by rubbing or waxing it
formerly - f. o. r. m. e. r. l. y.  - at a previous time
discussion - d. i. s. c. u. s. s. i. o. n.  - an extended communication dealing with a particular topic
reference - r. e. f. e. r. e. n. c. e.  - the act of consulting
mysterious - m. y. s. t. e. r. i. o. u. s.  - beyond ordinary understanding
annual - a. n. n. u. a. l.  - occurring every year
acquaintance - a. c. q. u. a. i. n. t. a. n. c. e.  - personal knowledge or information about someone or something
despair - d. e. s. p. a. i. r.  - a state in which all hope is lost or absent
foreign - f. o. r. e. i. g. n.  - not deriving from the essential nature of something
explanation - e. x. p. l. a. n. a. t. i. o. n.  - making something plain or intelligible
visible - vee. i. s. i. b. l. e.  - capable of being seen or open to easy view
extremely - e. x. t. r. e. m. e. l. y.  - to the greatest possible degree
origin - o. r. i. g. i. n.  - the place where something begins
sentence - s. e. n. t. e. n. c. e.  - a string of words satisfying grammatical rules of a language
sacrifice - s. a. c. r. i. f. i. c. e.  - the act of killing in order to appease a deity
lieutenant - l. i. e. u. t. e. n. a. n. t.  - a commissioned military officer
occasionally - o. c. c. a. s. i. o. n. a. l. l. y.  - now and then or here and there
valuable - vee. a. l. u. a. b. l. e.  - having worth or merit
conscience - c. o. n. s. c. i. e. n. c. e.  - motivation deriving from ethical or moral principles
violence - vee. i. o. l. e. n. c. e.  - a turbulent state resulting in injuries and destruction
performance - p. e. r. f. o. r. m. a. n. c. e.  - the act of doing something successfully
wholly - w. h. o. l. l. y.  - to the full or entire extent
forty - f. o. r. t. y.  - the cardinal number that is the product of ten and four
separate - s. e. p. a. r. a. t. e.  - standing apart; not attached to or supported by anything
description - d. e. s. c. r. i. p. t. i. o. n.  - the act of depicting something
February - F. e. b. r. u. a. r. y.  - the month following January and preceding March
belief - b. e. l. i. e. f.  - any cognitive content held as true
lovely - l. o. vee. e. l. y.  - lovable especially in a childlike or naive way
disease - d. i. s. e. a. s. e.  - an impairment of health
intelligence - i. n. t. e. l. l. i. g. e. n. c. e.  - the ability to comprehend
genius - g. e. n. i. u. s.  - unusual mental ability
imagine - i. m. a. g. i. n. e.  - expect, believe, or suppose
theory - t. h. e. o. r. y.  - a belief that can guide behavior
necessity - n. e. c. e. s. s. i. t. y.  - the condition of being essential or indispensable
peculiar - p. e. c. u. l. i. a. r.  - beyond or deviating from the usual or expected
parliament - p. a. r. l. i. a. m. e. n. t.  - a legislative assembly in certain countries
accept - a. c. c. e. p. t.  - receive willingly something given or offered
completely - c. o. m. p. l. e. t. e. l. y.  - with everything necessary
safety - s. a. f. e. t. y.  - being certain that adverse effects will not be caused
physical - p. h. y. s. i. c. a. l.  - involving the body as distinguished from the mind or spirit
truly - t. r. u. l. y.  - in accordance with fact or reality
fourth - f. o. u. r. t. h.  - following the third position
naturally - n. a. t. u. r. a. l. l. y.  - in a natural or normal manner
familiar - f. a. m. i. l. i. a. r.  - a friend who is frequently in the company of another
excellent - e. x. c. e. l. l. e. n. t.  - very good; of the highest quality
development - d. e. vee. e. l. o. p. m. e. n. t.  - a process in which something passes to a different stage
official - o. f. f. i. c. i. a. l.  - of or relating to a place of business
lose - l. o. s. e.  - fail to keep or to maintain
sufficient - s. u. f. f. i. c. i. e. n. t.  - of a quantity that can fulfill a need or requirement
emperor - e. m. p. e. r. o. r.  - the male ruler of an empire
begin - b. e. g. i. n.  - set in motion, cause to start
professor - p. r. o. f. e. s. s. o. r.  - a member of the faculty at a college or university
particularly - p. a. r. t. i. c. u. l. a. r. l. y.  - to a distinctly greater extent or degree than is common
difference - d. i. f. f. e. r. e. n. c. e.  - the quality of being unlike or dissimilar
committee - c. o. m. m. i. t. t. e. e.  - a special group delegated to consider some matter
existence - e. x. i. s. t. e. n. c. e.  - the state or fact of being
pleasant - p. l. e. a. s. a. n. t.  - being in harmony with your taste or likings
secretary - s. e. c. r. e. t. a. r. y.  - an assistant who handles correspondence and clerical work
surprise - s. u. r. p. r. i. s. e.  - come upon or take unawares
control - c. o. n. t. r. o. l.  - power to direct or determine
opportunity - o. p. p. o. r. t. u. n. i. t. y.  - a possibility from a favorable combination of circumstances
religious - r. e. l. i. g. i. o. u. s.  - having or showing belief in and reverence for a deity
minute - m. i. n. u. t. e.  - a unit of time equal to 60 seconds or 1/60th of an hour
governor - g. o. vee. e. r. n. o. r.  - the head of a state authority
usually - u. s. u. a. l. l. y.  - under normal conditions
similar - s. i. m. i. l. a. r.  - having the same or nearly the same characteristics
marriage - m. a. r. r. i. a. g. e.  - the state of being a couple voluntarily joined for life
colonel - c. o. l. o. n. e. l.  - a commissioned officer in the Army or Air Force or Marines
occasion - o. c. c. a. s. i. o. n.  - an event that occurs at a critical time
piece - p. i. e. c. e.  - a separate part of a whole
simply - s. i. m. p. l. y.  - in a simple manner; without extravagance or embellishment
entirely - e. n. t. i. r. e. l. y.  - to a complete degree or to the full or entire extent
easily - e. a. s. i. l. y.  - with ease (`easy' is sometimes used informally for `easily')
quiet - q. u. i. e. t.  - characterized by an absence of agitation or activity
information - i. n. f. o. r. m. a. t. i. o. n.  - knowledge acquired through study or experience
stop - s. t. o. p.  - have an end, in a temporal, spatial, or quantitative sense
appearance - a. p. p. e. a. r. a. n. c. e.  - outward or visible aspect of a person or thing
stopped - s. t. o. p. p. e. d.  - (of a nose) blocked
generally - g. e. n. e. r. a. l. l. y.  - usually; as a rule
success - s. u. c. c. e. s. s.  - an event that accomplishes its intended purpose
likely - l. i. k. e. l. y.  - having a good chance of being the case or of coming about
finally - f. i. n. a. l. l. y.  - as the end result of a sequence or process
experience - e. x. p. e. r. i. e. n. c. e.  - the content of observation or participation in an event
plan - p. l. a. n.  - a series of steps to be carried out or goals to be achieved
beginning - b. e. g. i. n. n. i. n. g.  - the act of starting something
government - g. o. vee. e. r. n. m. e. n. t.  - the system or form by which a community is ruled
immediately - i. m. m. e. d. i. a. t. e. l. y.  - without delay or hesitation; with no time intervening
length - l. e. n. g. t. h.  - the linear extent in space from one end to the other
strength - s. t. r. e. n. g. t. h.  - the property of being physically or mentally powerful
opinion - o. p. i. n. i. o. n.  - a personal belief or judgment
enemy - e. n. e. m. y.  - a personal foe
island - i. s. l. a. n. d.  - a land mass that is surrounded by water
especially - e. s. p. e. c. i. a. l. l. y.  - to a distinctly greater extent or degree than is common
knowledge - k. n. o. w. l. e. d. g. e.  - the result of perception, learning, and reasoning
minutes - m. i. n. u. t. e. s.  - a written account of what transpired at a meeting
except - e. x. c. e. p. t.  - prevent from being included or considered or accepted
probably - p. r. o. b. a. b. l. y.  - with considerable certainty; without much doubt
necessary - n. e. c. e. s. s. a. r. y.  - absolutely essential
hope - h. o. p. e.  - the general feeling that some desire will be fulfilled
chief - c. h. i. e. f.  - the head of a tribe or clan
across - a. c. r. o. s. s.  - to the opposite side
coming - c. o. m. i. n. g.  - of the relatively near future
either - e. i. t. h. e. r.  - used as an intensive after a negative meaning "likewise"
therefore - t. h. e. r. e. f. o. r. e.  - as a result; from that fact or reason
really - r. e. a. l. l. y.  - in actual fact
several - s. e. vee. e. r. a. l.  - of an indefinite number more than 2 or 3 but not many
till - t. i. l. l.  - work land as by ploughing to make it ready for cultivation
already - a. l. r. e. a. d. y.  - prior to a specified or implied time
quite - q. u. i. t. e.  - to the greatest extent; completely
enough - e. n. o. u. g. h.  - sufficient for the purpose
though - t. h. o. u. g. h.  - (postpositive) however
beyond this point is just for audio lesson

beyond this point is just for audio lesson
misspell -  . m. i. s. s. p. e. l. l.  - write the letters of incorrectly
dissatisfy - d. i. s. s. a. t. i. s. f. y.  - fail to please or meet expectations
dispensable - d. i. s. p. e. n. s. a. b. l. e.  - capable of being eliminated or done without
questionnaire - q. u. e. s. t. i. o. n. n. a. i. r. e.  - a form with a set of queries to gain statistical information
neutron - n. e. u. t. r. o. n.  - a subatomic particle with zero charge
possessive - p. o. s. s. e. s. s. i. vee. e.  - serving to express or indicate the act of having
Weird - W. e. i. r. d.  - fate personified; any one of the three Weird Sisters
fluorescent - f. l. u. o. r. e. s. c. e. n. t.  - emitting light during exposure to external radiant energy
believable - b. e. l. i. e. vee. a. b. l. e.  - capable of being accepted as true
harass - h. a. r. a. s. s.  - annoy continually or chronically
idiosyncrasy - i. d. i. o. s. y. n. c. r. a. s. y.  - a behavioral attribute peculiar to an individual
panicky - p. a. n. i. c. k. y.  - thrown into a state of intense fear or desperation
realistically - r. e. a. l. i. s. t. i. c. a. l. l. y.  - in a realistic manner
secede - s. e. c. e. d. e.  - withdraw from an organization or polity
quandary - q. u. a. n. d. a. r. y.  - state of uncertainty in a choice between unfavorable options
exaggerate - e. x. a. g. g. e. r. a. t. e.  - enlarge beyond bounds or the truth
fascinate - f. a. s. c. i. n. a. t. e.  - attract; cause to be enamored
mosquito - m. o. s. q. u. i. t. o.  - two-winged insect that sucks the blood of humans and animals
hesitancy - h. e. s. i. t. a. n. c. y.  - a feeling of diffidence and indecision about doing something
roommate - r. o. o. m. m. a. t. e.  - an associate who shares a room with you
guerrilla - g. u. e. r. r. i. l. l. a.  - a member of an irregular army that fights a stronger force
manageable - m. a. n. a. g. e. a. b. l. e.  - capable of being controlled
rhythmical - r. h. y. t. h. m. i. c. a. l.  - recurring with measured regularity
fallacious - f. a. l. l. a. c. i. o. u. s.  - containing or based on incorrect reasoning
fulfill - f. u. l. f. i. l. l.  - meet a want or need
pronunciation - p. r. o. n. u. n. c. i. a. t. i. o. n.  - the manner in which someone utters a word
ideally - i. d. e. a. l. l. y.  - in an ideal manner
aggravate - a. g. g. r. a. vee. a. t. e.  - make worse
sacrilegious - s. a. c. r. i. l. e. g. i. o. u. s.  - grossly irreverent toward what is considered holy
intercede - i. n. t. e. r. c. e. d. e.  - act between parties with a view to reconciling differences
supersede - s. u. p. e. r. s. e. d. e.  - take the place or move into the position of
quiz - q. u. i. z.  - an examination consisting of a few short questions
stubbornness - s. t. u. b. b. o. r. n. n. e. s. s.  - resolute adherence to your own ideas or desires
soliloquy - s. o. l. i. l. o. q. u. y.  - speech you make to yourself
allege - a. l. l. e. g. e.  - report or maintain
acclaim - a. c. c. l. a. i. m.  - enthusiastic approval
equip - e. q. u. i. p.  - provide with, usually for a specific purpose
heinous - h. e. i. n. o. u. s.  - extremely wicked or deeply criminal
refrigerator - r. e. f. r. i. g. e. r. a. t. o. r.  - white goods in which food can be stored at low temperatures
liaison - l. i. a. i. s. o. n.  - a means of communication between groups
lenient - l. e. n. i. e. n. t.  - inclined to be permissive or indulgent
quarantine - q. u. a. r. a. n. t. i. n. e.  - isolation to prevent the spread of infectious disease
omit - o. m. i. t.  - leave undone or leave out
counselor - c. o. u. n. s. e. l. o. r.  - someone who gives advice about problems
scary - s. c. a. r. y.  - provoking fear or terror
recede - r. e. c. e. d. e.  - pull back or move away or backward
permissible - p. e. r. m. i. s. s. i. b. l. e.  - acceptable, especially as according to rule
embarrass - e. m. b. a. r. r. a. s. s.  - cause to feel self-conscious
hypocrisy - h. y. p. o. c. r. i. s. y.  - pretending to have qualities or beliefs that you do not have
souvenir - s. o. u. vee. e. n. i. r.  - something of sentimental value
simile - s. i. m. i. l. e.  - a figure of speech expressing a resemblance between things
exuberance - e. x. u. b. e. r. a. n. c. e.  - joyful enthusiasm
symmetrical - s. y. m. m. e. t. r. i. c. a. l.  - exhibiting equivalence or correspondence among constituents
skiing - s. k. i. i. n. g.  - a sport in which participants must travel on skis
millionaire - m. i. l. l. i. o. n. a. i. r. e.  - a person whose material wealth is valued at more than a million dollars
maneuver - m. a. n. e. u. vee. e. r.  - a military training exercise
Hero - H. e. r. o.  - (Greek mythology) priestess of Aphrodite who killed herself when her lover Leander drowned while trying to swim the Hellespont to see her
criticize - c. r. i. t. i. c. i. z. e.  - point out real or perceived flaws
reminiscence - r. e. m. i. n. i. s. c. e. n. c. e.  - a mental impression retained and recalled from the past
portray - p. o. r. t. r. a. y.  - represent abstractly, for example in a painting
synonymous - s. y. n. o. n. y. m. o. u. s.  - meaning the same or nearly the same
fallacy - f. a. l. l. a. c. y.  - a misconception resulting from incorrect reasoning
curriculum - c. u. r. r. i. c. u. l. u. m.  - an integrated course of academic studies
accumulate - a. c. c. u. m. u. l. a. t. e.  - get or gather together
sophomore - s. o. p. h. o. m. o. r. e.  - a second-year undergraduate
feasible - f. e. a. s. i. b. l. e.  - capable of being done with means at hand
overrun - o. vee. e. r. r. u. n.  - seize the position of and defeat
rhythm - r. h. y. t. h. m.  - an interval during which a recurring sequence occurs
fundamentally - f. u. n. d. a. m. e. n. t. a. l. l. y.  - in essence; at bottom or by one's (or its) very nature
millennium - m. i. l. l. e. n. n. i. u. m.  - a span of 1000 years
disappoint - d. i. s. a. p. p. o. i. n. t.  - fail to meet the hopes or expectations of
humorous - h. u. m. o. r. o. u. s.  - characterized by the power to evoke laughter
courteous - c. o. u. r. t. e. o. u. s.  - characterized by politeness and gracious good manners
financially - f. i. n. a. n. c. i. a. l. l. y.  - from a financial point of view
receipt - r. e. c. e. i. p. t.  - the act of receiving
hindrance - h. i. n. d. r. a. n. c. e.  - any obstruction that impedes or is burdensome
hypocrite - h. y. p. o. c. r. i. t. e.  - a person who professes beliefs that he or she does not hold
fictitious - f. i. c. t. i. t. i. o. u. s.  - formed or conceived by the imagination
implement - i. m. p. l. e. m. e. n. t.  - a piece of equipment or a tool used for a specific purpose
irrelevant - i. r. r. e. l. e. vee. a. n. t.  - having no bearing on or connection with the subject at issue
rheumatism - r. h. e. u. m. a. t. i. s. m.  - any painful disorder of the joints or muscles
reservoir - r. e. s. e. r. vee. o. i. r.  - lake used to store water for community use
persistence - p. e. r. s. i. s. t. e. n. c. e.  - continuing or repeating behavior
Village - vee. i. l. l. a. g. e.  - a mainly residential district of Manhattan
schedule - s. c. h. e. d. u. l. e.  - a list of times at which things are planned to occur
guarantee - g. u. a. r. a. n. t. e. e.  - an unconditional commitment that something will happen
exhaust - e. x. h. a. u. s. t.  - wear out completely
achievement - a. c. h. i. e. vee. e. m. e. n. t.  - the action of accomplishing something
peaceable - p. e. a. c. e. a. b. l. e.  - inclined or disposed to peace
vigilant - vee. i. g. i. l. a. n. t.  - carefully observant or attentive
Independence - I. n. d. e. p. e. n. d. e. n. c. e.  - a city in western Missouri
maintenance - m. a. i. n. t. e. n. a. n. c. e.  - activity involved in keeping something in good working order
forfeit - f. o. r. f. e. i. t.  - lose the right to or lose by some error, offense, or crime
deceive - d. e. c. e. i. vee. e.  - cause someone to believe an untruth
vacuum - vee. a. c. u. u. m.  - an empty area or space
drunkenness - d. r. u. n. k. e. n. n. e. s. s.  - a temporary state resulting from excessive consumption of alcohol
apologize - a. p. o. l. o. g. i. z. e.  - acknowledge faults or shortcomings or failing
likelihood - l. i. k. e. l. i. h. o. o. d.  - the probability of a specified outcome
omission - o. m. i. s. s. i. o. n.  - leaving out or passing over something
tangible - t. a. n. g. i. b. l. e.  - perceptible by the senses, especially the sense of touch
foresee - f. o. r. e. s. e. e.  - realize beforehand
nuisance - n. u. i. s. a. n. c. e.  - anything that disturbs, endangers life, or is offensive
prescription - p. r. e. s. c. r. i. p. t. i. o. n.  - the action of issuing authoritative rules or directions
outrageous - o. u. t. r. a. g. e. o. u. s.  - greatly exceeding bounds of reason or moderation
ski - s. k. i.  - narrow wood or metal or plastic runners used in pairs for gliding over snow
optimism - o. p. t. i. m. i. s. m.  - the hopeful feeling that all is going to turn out well
bicycle - b. i. c. y. c. l. e.  - a vehicle that has two wheels and is moved by foot pedals
incidentally - i. n. c. i. d. e. n. t. a. l. l. y.  - by the way (used to introduce a new topic)
restaurant - r. e. s. t. a. u. r. a. n. t.  - a building where people go to eat
picnic - p. i. c. n. i. c.  - any informal meal eaten outside or on an excursion
dilemma - d. i. l. e. m. m. a.  - state of uncertainty in a choice between unfavorable options
defendant - d. e. f. e. n. d. a. n. t.  - someone against whom an action is brought in a court of law
accommodate - a. c. c. o. m. m. o. d. a. t. e.  - have room for; hold without crowding
dissatisfied - d. i. s. s. a. t. i. s. f. i. e. d.  - in a state of sulky dissatisfaction
pavilion - p. a. vee. i. l. i. o. n.  - a large and often sumptuous tent
longitude - l. o. n. g. i. t. u. d. e.  - the angular distance from the prime meridian at Greenwich
noticeable - n. o. t. i. c. e. a. b. l. e.  - capable of being detected
prevalent - p. r. e. vee. a. l. e. n. t.  - most frequent or common
strenuous - s. t. r. e. n. u. o. u. s.  - taxing to the utmost; testing powers of endurance
unnecessary - u. n. n. e. c. e. s. s. a. r. y.  - not needed
license - l. i. c. e. n. s. e.  - a legal document giving official permission to do something
unanimous - u. n. a. n. i. m. o. u. s.  - in complete agreement
syllable - s. y. l. l. a. b. l. e.  - a unit of spoken language larger than a phoneme
perseverance - p. e. r. s. e. vee. e. r. a. n. c. e.  - the act of persisting
surround - s. u. r. r. o. u. n. d.  - extend on all sides of simultaneously; encircle
susceptible - s. u. s. c. e. p. t. i. b. l. e.  - yielding readily to or capable of
interrupt - i. n. t. e. r. r. u. p. t.  - make a break in
ninety - n. i. n. e. t. y.  - the cardinal number that is the product of ten and nine
accessible - a. c. c. e. s. s. i. b. l. e.  - capable of being reached
missile - m. i. s. s. i. l. e.  - a weapon that is forcibly thrown or projected at a target
eligible - e. l. i. g. i. b. l. e.  - qualified for or allowed or worthy of being chosen
category - c. a. t. e. g. o. r. y.  - a general concept that marks divisions or coordinations
assassination - a. s. s. a. s. s. i. n. a. t. i. o. n.  - murder of a public figure by surprise attack
suppress - s. u. p. p. r. e. s. s.  - put down by force or authority
grievous - g. r. i. e. vee. o. u. s.  - causing or marked by grief or anguish
potato - p. o. t. a. t. o.  - an edible tuber native to South America
spontaneous - s. p. o. n. t. a. n. e. o. u. s.  - said or done without having been planned in advance
leisure - l. e. i. s. u. r. e.  - time available for ease and relaxation
mischievous - m. i. s. c. h. i. e. vee. o. u. s.  - naughtily or annoyingly playful
commitment - c. o. m. m. i. t. m. e. n. t.  - the act of binding yourself to a course of action
accidentally - a. c. c. i. d. e. n. t. a. l. l. y.  - without intention; in an unintentional manner
propaganda - p. r. o. p. a. g. a. n. d. a.  - information that is spread to promote some cause
forcibly - f. o. r. c. i. b. l. y.  - in a forcible manner
specifically - s. p. e. c. i. f. i. c. a. l. l. y.  - in distinction from others
technique - t. e. c. h. n. i. q. u. e.  - a practical method or art applied to some particular task
mathematics - m. a. t. h. e. m. a. t. i. c. s.  - a science dealing with the logic of quantity and arrangement
pronounce - p. r. o. n. o. u. n. c. e.  - speak or utter in a certain way
miniature - m. i. n. i. a. t. u. r. e.  - being on a very small scale
ecstasy - e. c. s. t. a. s. y.  - a state of elated bliss
pilgrimage - p. i. l. g. r. i. m. a. g. e.  - a journey to a sacred place
ordinarily - o. r. d. i. n. a. r. i. l. y.  - under normal conditions
advertisement - a. d. vee. e. r. t. i. s. e. m. e. n. t.  - a public promotion of some product or service
twelfth - t. w. e. l. f. t. h.  - position 12 in a countable series of things
accommodation - a. c. c. o. m. m. o. d. a. t. i. o. n.  - making or becoming suitable; adjusting to circumstances
privilege - p. r. i. vee. i. l. e. g. e.  - a special advantage or benefit not enjoyed by all
usage - u. s. a. g. e.  - the act of employing
disappearance - d. i. s. a. p. p. e. a. r. a. n. c. e.  - the event of passing out of sight
condemn - c. o. n. d. e. m. n.  - express strong disapproval of
subordinate - s. u. b. o. r. d. i. n. a. t. e.  - an assistant subject to the authority or control of another
penetrate - p. e. n. e. t. r. a. t. e.  - pass into or through, often by overcoming resistance
pitiful - p. i. t. i. f. u. l.  - deserving or inciting compassion
satellite - s. a. t. e. l. l. i. t. e.  - any celestial body orbiting around a planet or star
discipline - d. i. s. c. i. p. l. i. n. e.  - a system of rules of conduct or method of practice
gauge - g. a. u. g. e.  - an instrument for measuring and indicating a quantity
exceed - e. x. c. e. e. d.  - be or do something to a greater degree
loneliness - l. o. n. e. l. i. n. e. s. s.  - sadness resulting from being forsaken or abandoned
psychology - p. s. y. c. h. o. l. o. g. y.  - the science of mental life
hoarse - h. o. a. r. s. e.  - deep and harsh sounding as if from shouting or illness
dominant - d. o. m. i. n. a. n. t.  - most frequent or common
sponsor - s. p. o. n. s. o. r.  - an advocate who presents a person
relevant - r. e. l. e. vee. a. n. t.  - having a bearing on or connection with the subject at issue
repetition - r. e. p. e. t. i. t. i. o. n.  - the act of doing or performing again
influential - i. n. f. l. u. e. n. t. i. a. l.  - having or exercising power
calendar - c. a. l. e. n. d. a. r.  - a system of timekeeping that defines divisions of the year
oppression - o. p. p. r. e. s. s. i. o. n.  - the act of subjugating by cruelty
disastrous - d. i. s. a. s. t. r. o. u. s.  - having extremely unfortunate or dire consequences
obstacle - o. b. s. t. a. c. l. e.  - something that stands in the way and must be surmounted
column - c. o. l. u. m. n.  - a line of units following one after another
coolly - c. o. o. l. l. y.  - in a composed and unconcerned manner
nowadays - n. o. w. a. d. a. y. s.  - in these times
grammar - g. r. a. m. m. a. r.  - the branch of linguistics that deals with sentence structure
amateur - a. m. a. t. e. u. r.  - someone who pursues a study or sport as a pastime
imaginary - i. m. a. g. i. n. a. r. y.  - not based on fact; unreal
procedure - p. r. o. c. e. d. u. r. e.  - a particular course of action intended to achieve a result
succeed - s. u. c. c. e. e. d.  - attain success or reach a desired goal
laboratory - l. a. b. o. r. a. t. o. r. y.  - a workplace for the conduct of scientific research
statistics - s. t. a. t. i. s. t. i. c. s.  - a branch of mathematics concerned with quantitative data
competent - c. o. m. p. e. t. e. n. t.  - properly or sufficiently qualified, capable, or efficient
indispensable - i. n. d. i. s. p. e. n. s. a. b. l. e.  - essential
equipped - e. q. u. i. p. p. e. d.  - provided with whatever is necessary for a purpose
muscle - m. u. s. c. l. e.  - animal tissue consisting predominantly of contractile cells
villain - vee. i. l. l. a. i. n.  - someone who does evil deliberately
sincerely - s. i. n. c. e. r. e. l. y.  - without pretense
dining - d. i. n. i. n. g.  - the act of eating dinner
irresistible - i. r. r. e. s. i. s. t. i. b. l. e.  - impossible to withstand; overpowering
preference - p. r. e. f. e. r. e. n. c. e.  - the right or chance to choose
mortgage - m. o. r. t. g. a. g. e.  - a conveyance of property as security for repaying a loan
interference - i. n. t. e. r. f. e. r. e. n. c. e.  - the act of hindering or obstructing or impeding
occurrence - o. c. c. u. r. r. e. n. c. e.  - an instance of something happening
ninth - n. i. n. t. h.  - position nine in a countable series of things
consistent - c. o. n. s. i. s. t. e. n. t.  - the same throughout in structure or composition
efficiency - e. f. f. i. c. i. e. n. c. y.  - skillfulness in avoiding wasted time and effort
tyranny - t. y. r. a. n. n. y.  - government in which the ruler is an absolute dictator
comparative - c. o. m. p. a. r. a. t. i. vee. e.  - involving the examination of similarities and differences
excellence - e. x. c. e. l. l. e. n. c. e.  - possessing good qualities in high degree
opponent - o. p. p. o. n. e. n. t.  - someone who offers resistance
guidance - g. u. i. d. a. n. c. e.  - the act of showing the way
cigarette - c. i. g. a. r. e. t. t. e.  - finely ground tobacco wrapped in paper; for smoking
descend - d. e. s. c. e. n. d.  - move downward and lower, but not necessarily all the way
scenery - s. c. e. n. e. r. y.  - the appearance of a place
transfer - t. r. a. n. s. f. e. r.  - move from one place to another
recommend - r. e. c. o. m. m. e. n. d.  - express a good opinion of
legitimate - l. e. g. i. t. i. m. a. t. e.  - in accordance with accepted standards or principles
specimen - s. p. e. c. i. m. e. n.  - a bit of tissue or fluid taken for diagnostic purposes
dine - d. i. n. e.  - have supper; eat dinner
continuous - c. o. n. t. i. n. u. o. u. s.  - moving in time or space without interruption
thorough - t. h. o. r. o. u. g. h.  - painstakingly careful and accurate
appreciation - a. p. p. r. e. c. i. a. t. i. o. n.  - understanding of the nature or meaning of something
judicial - j. u. d. i. c. i. a. l.  - expressing careful judgment
eighth - e. i. g. h. t. h.  - position eight in a countable series of things
murmur - m. u. r. m. u. r.  - a low continuous indistinct sound
remembrance - r. e. m. e. m. b. r. a. n. c. e.  - the ability to recall past occurrences
relieve - r. e. l. i. e. vee. e.  - free from a burden, evil, or distress
controlled - c. o. n. t. r. o. l. l. e. d.  - restrained or managed or kept within certain bounds
Wednesday - W. e. d. n. e. s. d. a. y.  - the fourth day of the week; the third working day
resemblance - r. e. s. e. m. b. l. a. n. c. e.  - similarity in appearance or external or superficial details
incredible - i. n. c. r. e. d. i. b. l. e.  - extraordinarily good or great
warrant - w. a. r. r. a. n. t.  - formal and explicit approval
suspicious - s. u. s. p. i. c. i. o. u. s.  - openly distrustful and unwilling to confide
tournament - t. o. u. r. n. a. m. e. n. t.  - a competition in which contestants play a series of games
definitely - d. e. f. i. n. i. t. e. l. y.  - without question and beyond doubt
prejudice - p. r. e. j. u. d. i. c. e.  - a partiality preventing objective consideration of an issue
alleged - a. l. l. e. g. e. d.  - doubtful or suspect
shepherd - s. h. e. p. h. e. r. d.  - someone who keeps sheep together in a flock
publicly - p. u. b. l. i. c. l. y.  - in a manner accessible to or observable by the public
accomplish - a. c. c. o. m. p. l. i. s. h.  - achieve with effort
independent - i. n. d. e. p. e. n. d. e. n. t.  - free from external control and constraint
technical - t. e. c. h. n. i. c. a. l.  - of or relating to aptitude in a practical skill
shine - s. h. i. n. e.  - emit light; be bright, as of the sun or a light
equivalent - e. q. u. i. vee. a. l. e. n. t.  - being essentially comparable to something
dependent - d. e. p. e. n. d. e. n. t.  - a person who relies on another person for support
introduce - i. n. t. r. o. d. u. c. e.  - bring something new to an environment
abundance - a. b. u. n. d. a. n. c. e.  - the property of a more than adequate quantity or supply
salary - s. a. l. a. r. y.  - fixed payment for services
courtesy - c. o. u. r. t. e. s. y.  - a considerate and respectful manner
neighbor - n. e. i. g. h. b. o. r.  - a person who lives near another
strategy - s. t. r. a. t. e. g. y.  - an elaborate and systematic plan of action
subtle - s. u. b. t. l. e.  - difficult to detect or grasp by the mind or analyze
conceive - c. o. n. c. e. i. vee. e.  - have the idea for
absence - a. b. s. e. n. c. e.  - the state of being not present
seize - s. e. i. z. e.  - take hold of; grab
refer - r. e. f. e. r.  - make a remark that calls attention to
appetite - a. p. p. e. t. i. t. e.  - a feeling of craving something
tomorrow - t. o. m. o. r. r. o. w.  - the day after today
handkerchief - h. a. n. d. k. e. r. c. h. i. e. f.  - a square piece of cloth used for wiping the eyes or nose
desirable - d. e. s. i. r. a. b. l. e.  - worth having or seeking or achieving
planning - p. l. a. n. n. i. n. g.  - an act of formulating a program for a course of action
parallel - p. a. r. a. l. l. e. l.  - being everywhere equidistant and not intersecting
jealousy - j. e. a. l. o. u. s. y.  - a feeling of envy, especially of a rival
height - h. e. i. g. h. t.  - distance from the base of something to its top
pursue - p. u. r. s. u. e.  - follow in an effort to capture
convenient - c. o. n. vee. e. n. i. e. n. t.  - suited to your comfort or purpose or needs
vengeance - vee. e. n. g. e. a. n. c. e.  - harming someone in retaliation for something they have done
luxury - l. u. x. u. r. y.  - something that is an indulgence rather than a necessity
climb - c. l. i. m. b.  - go up or advance
correspondence - c. o. r. r. e. s. p. o. n. d. e. n. c. e.  - an attribute of a shape or relation
happily - h. a. p. p. i. l. y.  - in a joyous manner
lightning - l. i. g. h. t. n. i. n. g.  - flash of light from an electric discharge in the atmosphere
develop - d. e. vee. e. l. o. p.  - progress or evolve through a process of natural growth
obedience - o. b. e. d. i. e. n. c. e.  - the trait of being willing to follow commands or guidance
primitive - p. r. i. m. i. t. i. vee. e.  - characteristic of an earlier ancestral type
temperature - t. e. m. p. e. r. a. t. u. r. e.  - the degree of hotness or coldness of a body or environment
sergeant - s. e. r. g. e. a. n. t.  - a noncommissioned officer ranking above a corporal
preparation - p. r. e. p. a. r. a. t. i. o. n.  - setting in order in advance some act or purpose
perceive - p. e. r. c. e. i. vee. e.  - become aware of through the senses
undoubtedly - u. n. d. o. u. b. t. e. d. l. y.  - certainly
inevitable - i. n. e. vee. i. t. a. b. l. e.  - incapable of being avoided or prevented
insurance - i. n. s. u. r. a. n. c. e.  - protection against future loss
prominent - p. r. o. m. i. n. e. n. t.  - conspicuous in position or importance
experiment - e. x. p. e. r. i. m. e. n. t.  - the act of conducting a controlled test or investigation
narrative - n. a. r. r. a. t. i. vee. e.  - an account that tells the particulars of an act or event
physician - p. h. y. s. i. c. i. a. n.  - a licensed medical practitioner
preferred - p. r. e. f. e. r. r. e. d.  - more desirable than another
succession - s. u. c. c. e. s. s. i. o. n.  - the action or process of taking over an office or position
address - a. d. d. r. e. s. s.  - the place where a person or organization can be found
recognize - r. e. c. o. g. n. i. z. e.  - perceive to be something or something you can identify
prefer - p. r. e. f. e. r.  - like better; value more highly
tendency - t. e. n. d. e. n. c. y.  - an inclination to do something
occur - o. c. c. u. r.  - come to pass
representative - r. e. p. r. e. s. e. n. t. a. t. i. vee. e.  - serving to typify
realize - r. e. a. l. i. z. e.  - be fully aware or cognizant of
practically - p. r. a. c. t. i. c. a. l. l. y.  - in a manner concerned with actual use
wherever - w. h. e. r. e. vee. e. r.  - where in the world
receive - r. e. c. e. i. vee. e.  - get something; come into possession of
resistance - r. e. s. i. s. t. a. n. c. e.  - any mechanical force that tends to slow or oppose motion
medicine - m. e. d. i. c. i. n. e.  - the profession devoted to alleviating diseases and injuries
ignorance - i. g. n. o. r. a. n. c. e.  - the lack of knowledge or education
permit - p. e. r. m. i. t.  - allow the presence of or allow without opposing
favorite - f. a. vee. o. r. i. t. e.  - preferred above all others and treated with partiality
maintain - m. a. i. n. t. a. i. n.  - keep in a certain state, position, or activity
permanent - p. e. r. m. a. n. e. n. t.  - continuing or enduring without marked change in status
expense - e. x. p. e. n. s. e.  - a financial burden; money that must be paid out
possess - p. o. s. s. e. s. s.  - have ownership of
desperate - d. e. s. p. e. r. a. t. e.  - a person who is frightened and in need of help
magazine - m. a. g. a. z. i. n. e.  - a periodic publication containing articles and pictures
proceed - p. r. o. c. e. e. d.  - move ahead; travel onward in time or space
consciousness - c. o. n. s. c. i. o. u. s. n. e. s. s.  - an alert cognitive state in which you are aware of yourself
shining - s. h. i. n. i. n. g.  - the work of making something smooth and shiny by rubbing or waxing it
formerly - f. o. r. m. e. r. l. y.  - at a previous time
discussion - d. i. s. c. u. s. s. i. o. n.  - an extended communication dealing with a particular topic
reference - r. e. f. e. r. e. n. c. e.  - the act of consulting
mysterious - m. y. s. t. e. r. i. o. u. s.  - beyond ordinary understanding
annual - a. n. n. u. a. l.  - occurring every year
acquaintance - a. c. q. u. a. i. n. t. a. n. c. e.  - personal knowledge or information about someone or something
despair - d. e. s. p. a. i. r.  - a state in which all hope is lost or absent
foreign - f. o. r. e. i. g. n.  - not deriving from the essential nature of something
explanation - e. x. p. l. a. n. a. t. i. o. n.  - making something plain or intelligible
visible - vee. i. s. i. b. l. e.  - capable of being seen or open to easy view
extremely - e. x. t. r. e. m. e. l. y.  - to the greatest possible degree
origin - o. r. i. g. i. n.  - the place where something begins
sentence - s. e. n. t. e. n. c. e.  - a string of words satisfying grammatical rules of a language
sacrifice - s. a. c. r. i. f. i. c. e.  - the act of killing in order to appease a deity
lieutenant - l. i. e. u. t. e. n. a. n. t.  - a commissioned military officer
occasionally - o. c. c. a. s. i. o. n. a. l. l. y.  - now and then or here and there
valuable - vee. a. l. u. a. b. l. e.  - having worth or merit
conscience - c. o. n. s. c. i. e. n. c. e.  - motivation deriving from ethical or moral principles
violence - vee. i. o. l. e. n. c. e.  - a turbulent state resulting in injuries and destruction
performance - p. e. r. f. o. r. m. a. n. c. e.  - the act of doing something successfully
wholly - w. h. o. l. l. y.  - to the full or entire extent
forty - f. o. r. t. y.  - the cardinal number that is the product of ten and four
separate - s. e. p. a. r. a. t. e.  - standing apart; not attached to or supported by anything
description - d. e. s. c. r. i. p. t. i. o. n.  - the act of depicting something
February - F. e. b. r. u. a. r. y.  - the month following January and preceding March
belief - b. e. l. i. e. f.  - any cognitive content held as true
lovely - l. o. vee. e. l. y.  - lovable especially in a childlike or naive way
disease - d. i. s. e. a. s. e.  - an impairment of health
intelligence - i. n. t. e. l. l. i. g. e. n. c. e.  - the ability to comprehend
genius - g. e. n. i. u. s.  - unusual mental ability
imagine - i. m. a. g. i. n. e.  - expect, believe, or suppose
theory - t. h. e. o. r. y.  - a belief that can guide behavior
necessity - n. e. c. e. s. s. i. t. y.  - the condition of being essential or indispensable
peculiar - p. e. c. u. l. i. a. r.  - beyond or deviating from the usual or expected
parliament - p. a. r. l. i. a. m. e. n. t.  - a legislative assembly in certain countries
accept - a. c. c. e. p. t.  - receive willingly something given or offered
completely - c. o. m. p. l. e. t. e. l. y.  - with everything necessary
safety - s. a. f. e. t. y.  - being certain that adverse effects will not be caused
physical - p. h. y. s. i. c. a. l.  - involving the body as distinguished from the mind or spirit
truly - t. r. u. l. y.  - in accordance with fact or reality
fourth - f. o. u. r. t. h.  - following the third position
naturally - n. a. t. u. r. a. l. l. y.  - in a natural or normal manner
familiar - f. a. m. i. l. i. a. r.  - a friend who is frequently in the company of another
excellent - e. x. c. e. l. l. e. n. t.  - very good; of the highest quality
development - d. e. vee. e. l. o. p. m. e. n. t.  - a process in which something passes to a different stage
official - o. f. f. i. c. i. a. l.  - of or relating to a place of business
lose - l. o. s. e.  - fail to keep or to maintain
sufficient - s. u. f. f. i. c. i. e. n. t.  - of a quantity that can fulfill a need or requirement
emperor - e. m. p. e. r. o. r.  - the male ruler of an empire
begin - b. e. g. i. n.  - set in motion, cause to start
professor - p. r. o. f. e. s. s. o. r.  - a member of the faculty at a college or university
particularly - p. a. r. t. i. c. u. l. a. r. l. y.  - to a distinctly greater extent or degree than is common
difference - d. i. f. f. e. r. e. n. c. e.  - the quality of being unlike or dissimilar
committee - c. o. m. m. i. t. t. e. e.  - a special group delegated to consider some matter
existence - e. x. i. s. t. e. n. c. e.  - the state or fact of being
pleasant - p. l. e. a. s. a. n. t.  - being in harmony with your taste or likings
secretary - s. e. c. r. e. t. a. r. y.  - an assistant who handles correspondence and clerical work
surprise - s. u. r. p. r. i. s. e.  - come upon or take unawares
control - c. o. n. t. r. o. l.  - power to direct or determine
opportunity - o. p. p. o. r. t. u. n. i. t. y.  - a possibility from a favorable combination of circumstances
religious - r. e. l. i. g. i. o. u. s.  - having or showing belief in and reverence for a deity
minute - m. i. n. u. t. e.  - a unit of time equal to 60 seconds or 1/60th of an hour
governor - g. o. vee. e. r. n. o. r.  - the head of a state authority
usually - u. s. u. a. l. l. y.  - under normal conditions
similar - s. i. m. i. l. a. r.  - having the same or nearly the same characteristics
marriage - m. a. r. r. i. a. g. e.  - the state of being a couple voluntarily joined for life
colonel - c. o. l. o. n. e. l.  - a commissioned officer in the Army or Air Force or Marines
occasion - o. c. c. a. s. i. o. n.  - an event that occurs at a critical time
piece - p. i. e. c. e.  - a separate part of a whole
simply - s. i. m. p. l. y.  - in a simple manner; without extravagance or embellishment
entirely - e. n. t. i. r. e. l. y.  - to a complete degree or to the full or entire extent
easily - e. a. s. i. l. y.  - with ease (`easy' is sometimes used informally for `easily')
quiet - q. u. i. e. t.  - characterized by an absence of agitation or activity
information - i. n. f. o. r. m. a. t. i. o. n.  - knowledge acquired through study or experience
stop - s. t. o. p.  - have an end, in a temporal, spatial, or quantitative sense
appearance - a. p. p. e. a. r. a. n. c. e.  - outward or visible aspect of a person or thing
stopped - s. t. o. p. p. e. d.  - (of a nose) blocked
generally - g. e. n. e. r. a. l. l. y.  - usually; as a rule
success - s. u. c. c. e. s. s.  - an event that accomplishes its intended purpose
likely - l. i. k. e. l. y.  - having a good chance of being the case or of coming about
finally - f. i. n. a. l. l. y.  - as the end result of a sequence or process
experience - e. x. p. e. r. i. e. n. c. e.  - the content of observation or participation in an event
plan - p. l. a. n.  - a series of steps to be carried out or goals to be achieved
beginning - b. e. g. i. n. n. i. n. g.  - the act of starting something
government - g. o. vee. e. r. n. m. e. n. t.  - the system or form by which a community is ruled
immediately - i. m. m. e. d. i. a. t. e. l. y.  - without delay or hesitation; with no time intervening
length - l. e. n. g. t. h.  - the linear extent in space from one end to the other
strength - s. t. r. e. n. g. t. h.  - the property of being physically or mentally powerful
opinion - o. p. i. n. i. o. n.  - a personal belief or judgment
enemy - e. n. e. m. y.  - a personal foe
island - i. s. l. a. n. d.  - a land mass that is surrounded by water
especially - e. s. p. e. c. i. a. l. l. y.  - to a distinctly greater extent or degree than is common
knowledge - k. n. o. w. l. e. d. g. e.  - the result of perception, learning, and reasoning
minutes - m. i. n. u. t. e. s.  - a written account of what transpired at a meeting
except - e. x. c. e. p. t.  - prevent from being included or considered or accepted
probably - p. r. o. b. a. b. l. y.  - with considerable certainty; without much doubt
necessary - n. e. c. e. s. s. a. r. y.  - absolutely essential
hope - h. o. p. e.  - the general feeling that some desire will be fulfilled
chief - c. h. i. e. f.  - the head of a tribe or clan
across - a. c. r. o. s. s.  - to the opposite side
coming - c. o. m. i. n. g.  - of the relatively near future
either - e. i. t. h. e. r.  - used as an intensive after a negative meaning "likewise"
therefore - t. h. e. r. e. f. o. r. e.  - as a result; from that fact or reason
really - r. e. a. l. l. y.  - in actual fact
several - s. e. vee. e. r. a. l.  - of an indefinite number more than 2 or 3 but not many
till - t. i. l. l.  - work land as by ploughing to make it ready for cultivation
already - a. l. r. e. a. d. y.  - prior to a specified or implied time
quite - q. u. i. t. e.  - to the greatest extent; completely
enough - e. n. o. u. g. h.  - sufficient for the purpose
though - t. h. o. u. g. h.  - (postpositive) however
beyond this point is just for audio lesson

