las cortinas en toda la casa son gruesas - the curtains in the whole house are thick - no hint
un espejo antiguo y una mesa de madera fina están en el vestíbulo - an antique mirror and a fine wood table are in the hall - no hint
el comedor es sencillo - the dining room is simple - no hint
con una mesa y seis sillas - with a table and six chairs - no hint
la alfombra es roja y azul marino - the rug is red and navy blue - no hint
la cocina es amplia - the kitchen is spacious - no hint
la nevera es bastante grande - the fridge is quite big - no hint
dos sillones cómodos - two comfortable armchairs - no hint
mis cuadernos están en el estudio - my notebooks are in the study - no hint
hay tres libros en el piso - there are three books on the floor - no hint
hay una mes marrón en el cuarto - there is a brown month in the room - no hint
hay estrellas en el cielo - there are stars in the sky - no hint
dónde está la casa del alcalde - where is the mayor's house - no hint
qué hay en el menú - what's on the menu - no hint
cuál es la capital de perú - what is the capital of peru - no hint
el jueves es el día de acción de gracias - thursday is thanksgiving day - no hint
el martes es el día del amor y la amistad - tuesday is the day of love and friendship - no hint
estamos en clase los miércoles - we are in class on wednesdays - no hint
enero - january - no hint
el verano - summer - no hint
el otoño - fall - no hint
el invierno - winter - no hint
la primavera - spring - no hint
la alcoba - the bedroom - no hint
el comedor - the dining room - no hint
el cuaderno - the notebook - no hint
el espejo - mirror - no hint
el estudio - the study - no hint
la estufa - the stove - no hint
el horno - the oven - no hint
el lápiz - the pencil - no hint
la madera - timber - no hint
la nevera - the fridge - no hint
el patio - the backyard - no hint
la sala - la sala - no hint
el sillón - the couch - no hint
el vestíbulo - the hall - no hint
madera fina - fine wood - no hint
todavía - yet - no hint
la madre de ella es arqueóloga - her mother is an archaeologist - no hint
hay muchas clases de lunes a viernes - there are many classes from monday to friday - no hint
estoy feliz en la casa de piedra en las montañas - i am happy in the stone house in the mountains - no hint
la persona agradable - the nice person - no hint
la obra emocionante - the exciting work - no hint
el día lindo - the beautiful day - no hint
el edificio bajo - the low building - no hint
el sueño raro - the weird dream - no hint
la guerra larga - the long war - no hint
la avenida ancha - the broad avenue - no hint
el niño cariñoso - the affectionate child - no hint
la persona baja - the person goes down - no hint
el mes corto - the short month - no hint
la mujer amistosa - the friendly woman - no hint
el hombre amable - the kind man - no hint
la tarea fácil - the easy task - no hint
la playa hermosa - the beautiful beach - no hint
la avenida estrecha - the narrow avenue - no hint
las personas orgullosas - the proud people - no hint
es ella flaca porque ella está enferma - is she skinny because she is sick - no hint
