tavuk - chicken - no hint
çayı - tea i - no hint
bir - a - no hint
müzik - music - no hint
özgeçmiş - resume - no hint
gündeminin - your agenda - no hint
sonucu - results - no hint
piskopos - bishop - no hint
büyük - big - no hint
gün - day - no hint
merak - curiosity - no hint
ediyorum - i do - no hint
sütunları - columns - no hint
şaka - joke - no hint
yapıyor - doing - no hint
çiftliklerimiz - our farms - no hint
polemik - polemic - no hint
bağırıyorlar - they are shouting - no hint
şato - castle - no hint
masası - desk - no hint
insanlar - people - no hint
ölüyor - is happening - no hint
lapa - page - no hint
onlar - them - no hint
donna - woman - no hint
bella - pretty - no hint
mia - my - no hint
dilek - wish - no hint
olsun - never mind - no hint
uyandır - wake up - no hint
beni - me - no hint
dolarlık - dollar - no hint
banknot - banknote - no hint
sütununa - to the column - no hint
göre - according to - no hint
basım - printing - no hint
benim - mine - no hint
metier - job - no hint
artemisia - mugwort - no hint
herhangi - any - no hint
gerçekçiyim - i am realistic - no hint
mars - march - no hint
alma'nın - of alma - no hint
kökeni - origin - no hint
oksijen - oxygen - no hint
damos - we give - no hint
ders - lesson - no hint
almalı - should take - no hint
tüm - all - no hint
fare - do - no hint
bizim - ours - no hint
konuşmalı - should talk - no hint
jack - jack - no hint
git - go - no hint
peck - peck - no hint
yalamak - to lick - no hint
olacak - it will be - no hint
anahtarımı - my key - no hint
al - to the - no hint
samson - samson - no hint
neredeyse - almost - no hint
tek - single - no hint
hilebaz - hilebaz - no hint
şakacı - playful - no hint
pislik - dirt - no hint
pecola - sheep - no hint
karada - karada - no hint
kazığı - stake - no hint
misin - will you - no hint
ateşkes - truce - no hint
peşinde - chasing after - no hint
koşar - runs - no hint
alkış - applause - no hint
eridan - from her husband - no hint
cool - cool - no hint
kitch - kitch - no hint
bayan - lady - no hint
kini - now - no hint
kuşu - bird - no hint
silva - bramble - no hint
varla - hardly - no hint
diliyorum - i wish - no hint
abla - elder sister - no hint
luke - luke - no hint
evet - yeah - no hint
bon - well - no hint
odori - smells - no hint
bona - good - no hint
oldu - it happened - no hint
buraya - here - no hint
bar - bar - no hint
masasında - at his desk - no hint
cimri - stingy - no hint
şey - thing - no hint
hakkında - about - no hint
meditasyon - meditation - no hint
yapmak - to do - no hint
için - for - no hint
geldim - i came - no hint
tamam - ok - no hint
da - gives - no hint
otoriter - authoritarian - no hint
dipleri - bottoms - no hint
liam - liam - no hint
hepimiz - we all - no hint
cüretkarlıkta - in audacity - no hint
onu - him her it - no hint
yanıltma - mislead - no hint
ihtimali - possibility of - no hint
palmer'ın - of the palmer - no hint
alma'sı - receive - no hint
oahu - oahu - no hint
kadar - until - no hint
guzik - button - no hint
birbirlerine - to each other - no hint
mamba - mamba - no hint
göster - show - no hint
haydut - bandit - no hint
yumurta - egg - no hint
yıkama - washing - no hint
operamı - my opera - no hint
yaparmısın - would you - no hint
makarna - pasta - no hint
pişirirmisin - can you cook - no hint
digiovanni - digiovanni - no hint
papağan - parrot - no hint
yarım - my love - no hint
balık - fish - no hint
avı - hunt - no hint
kaka - kaka - no hint
kralı - king of - no hint
okyanus - ocean - no hint
kazan - boiler - no hint
keşke - if only - no hint
las - the - no hint
çakrasında - in the chakra - no hint
iddia - allegation - no hint
etseler - if they do - no hint
ej - not - no hint
boy - boy - no hint
vernik - varnish - no hint
yani - well - no hint
tabuk - tabuk - no hint
kadastro - cadastral survey - no hint
ve - and - no hint
uyumsuzluk - mismatch - no hint
luigi - louis - no hint
atmosferik - atmospheric - no hint
onun - her - no hint
içinde - inside - no hint
düzenlenmiştir - edited - no hint
parminder - parminder - no hint
anatomi - anatomy - no hint
türbülansı - turbulence - no hint
külçesi - nugget - no hint
dinamik - dynamic - no hint
tarihi - date - no hint
öğesi - item - no hint
bu - this - no hint
olas - waves - no hint
yapar - makes - no hint
bugan - bugan - no hint
manejar - handle - no hint
kahretsin - damn - no hint
rengi - color - no hint
bay - bay - no hint
top - ball - no hint
bucky - bucky - no hint
sturm - storm - no hint
yasak - forbidden - no hint
pazartesi - monday - no hint
harika - great - no hint
altını - gold - no hint
kim - needle - no hint
değiştirebilir - can change - no hint
diyorsun - you say - no hint
neden - why - no hint
yap - do it - no hint
öldürebilir - can kill - no hint
otobüse - to the bus - no hint
bin - am - no hint
düzen - order - no hint
ama - but - no hint
yüzden - why - no hint
harmonik - harmonic - no hint
adams - adams - no hint
tarafından - by - no hint
geliyor - is coming - no hint
inhibitör - inhibitor - no hint
ar - with - no hint
suresini - the duration - no hint
kazıyorsa - if he is digging - no hint
doğuştan - congenital - no hint
um - a - no hint
stilisti - stylists - no hint
kabul - acceptance - no hint
kıyafeti - outfit - no hint
varma - sure - no hint
azarlama - rebuke - no hint
boo - boo - no hint
yapma - do not do that - no hint
hanımefendi - lady - no hint
maquis - scrub - no hint
kolları - handles - no hint
şakada - in joke - no hint
çalıştın - you worked - no hint
azar - random - no hint
yiyorsun - you are eating - no hint
bani - money - no hint
adam'da - in man - no hint
bademleri - almonds - no hint
yemi - feed - no hint
pamuğu - cotton - no hint
azarladı - scolded - no hint
bankada - in the bank - no hint
amir - prince - no hint
dip - dip - no hint
kucik - puppy - no hint
ceylan - gazelle - no hint
buddha - buddha - no hint
etik - ethic - no hint
pasilla - corridor - no hint
yahudi - jewish - no hint
günü - day - no hint
kuja - to come - no hint
huna - hun - no hint
makia - makia - no hint
arca - face - no hint
la - the - no hint
yarda - yard - no hint
bölgesi - region - no hint
arabada - in the car - no hint
bulaşıklar - the dishes - no hint
yıkamak - wash - no hint
doğmuş - born - no hint
makyaj - make/up - no hint
anne - anne - no hint
kimmy - kimmy - no hint
nimet - names - no hint
katlanılabilir - bearable - no hint
dyson - dyson - no hint
alma'sının - of the alma - no hint
patlaması - explosion - no hint
üzerine - over - no hint
şiir - poem - no hint
yaz - summer - no hint
makin - more - no hint
belki - maybe - no hint
adam - adam - no hint
domos - houses - no hint
kemiksiz - boneless - no hint
seviyede - level - no hint
ara - now - no hint
kappa - kappa - no hint
ilacım - my medicine - no hint
çok - lots - no hint
daha - more - no hint
küçük - small - no hint
mas - but - no hint
makyajımı - my makeup - no hint
abhi - abhi - no hint
adamım - my man - no hint
kopyala - copy - no hint
patlama - explosion - no hint
hırsızlık - theft - no hint
labella - the beautiful - no hint
mola - spring - no hint
paloma - dove - no hint
fatura - invoice - no hint
üyemi - am i a member - no hint
oluşturuyor - making up - no hint
puslu - misty - no hint
tesora - tesora - no hint
soleil - sun - no hint
her - her - no hint
biri - somebody - no hint
acı - angle - no hint
boğucu - stifling - no hint
aptal - stupid - no hint
piyan - piyan - no hint
mahathir - mahathir - no hint
bacak - leg - no hint
tafta - taffeta - no hint
baktun - baktun - no hint
salir - get out - no hint
kimi - whom - no hint
soğan - onion - no hint
bania - bania - no hint
odasında - in his room - no hint
bile - even - no hint
hoşgeldiniz - welcome - no hint
yüksek - high school - no hint
isyanı - revolt - no hint
kabadayı - rowdy - no hint
kaptanı - captain - no hint
veya - or - no hint
minibüs - minibus - no hint
arabaları - cars - no hint
sesi - session - no hint
bana - to me - no hint
yaptır - make it - no hint
bir zamanlar - once upon a time - no hint
çiftlikte - in a farm - no hint
hayvanların yiyecek hiçbir şeyi yoktu - the animals had nothing to eat - no hint
onlar biz çok açız - they we're very hungry - no hint
bu yüzden pişirmeye karar verdiler - so they decided to cook - no hint
küçük kırmızı tavuk - the little red hen - no hint
buğday tohumu buldum - found a wheat seed - no hint
ve arkadaşlarına anlatmak için koştu - and rushed to tell her friends - no hint
belki ona yardım ederlerdi - perhaps they would help her - no hint
tohumu ek - plant the seed - no hint
bana kim yardım edecek - who will help me - no hint
bu buğdayı ek - plant this wheat - no hint
inek bana yardım edecek misin - cow will you help me - no hint
bu tohumu ekmek - to plant this seed - no hint
ben değil - not i - no hint
bunu yapmak için çok güneşli - it's too sunny to do it - no hint
domuz bana yardım edecek misin - pig will you help me - no hint
köpek bana yardım eder misin - dog will you help me - no hint
tohum dikmek için hayır - to plant the seed no - no hint
o zaman hepsini tek başıma yapacağım - then i shall do it all alone - no hint
küçük kırmızı tavuk tohumu ekti - so the little red hen planted the seed - no hint
hepsi tek başlarına - all by herself - no hint
birkaç gün geçti - several days went by - no hint
parlak bir güneş ışığı vardı - there was a bright sunshine - no hint
yağmur yağdı - it rained - no hint
küçük kırmızı tavuk ot yemeye karar verdi - the little red hen decided to weed - no hint
bu tohumu ot için bana kim yardım edecek - who will help me weed this seed - no hint
bahçeyi otla - weed the garden - no hint
bahçe ile - with the garden - no hint
hava çok hoş - the weather is too pleasant - no hint
tamam o zaman yapacağım - okay then i will do it - no hint
küçük kırmızı tavuk otları ayıkladı ve eğildi - so the little red hen weeded and tended - no hint
hafta geçtikçe - as the week's went by - no hint
güneş buğdayı olgunlaştırdı - the sun ripened the wheat - no hint
hasat için hazır olana kadar - until it was ready to harvest - no hint
buğday uzun ve güçlü büyümüştü - the wheat had grown tall and strong - no hint
küçük kırmızı tavuk arkadaşlarından ona yardım etmelerini istemeye karar verdi. - so the little red hen decided to ask her friends to help her - no hint
buğdayı harmanlamak - thresh the wheat - no hint
inek buğdayı harmanlamama yardım eder misin - cow will you help me thresh the wheat - no hint
dinlenmek istiyorum - i want to rest - no hint
bugün ahırımda - in my barn today - no hint
domuz buğdayı harmanlamama yardım eder misin - pig will you help me thresh the wheat - no hint
oynamak istiyorum - i want to play - no hint
bugün çamurda - in the mud today - no hint
köpek otu harmanlamama yardım eder misin - dog will you help me thresh the weed - no hint
ben değil ben - not i not i - no hint
kemiğimi bulmak istiyorum - i want to find my bone - no hint
bugün köpek kulübesinde - in the doghouse today - no hint
tamam o zaman yapacağım - ok then i will do it - no hint
yapayalnız - all alone - no hint
küçük kırmızı tavuğa kimse yardım etmedi - no one helped little red hen - no hint
bu yüzden bir kez daha tüm işi kendi başına yapmak zorunda kaldı - so once again she had to do all the work by herself - no hint
bu yüzden buğdayı dövdü - so she thrashed the wheat - no hint
o bitirdikten sonra - after she finished - no hint
arkadaşlarına sordu - she asked her friends - no hint
ona yardım etmek için - to help her - no hint
buğdayı un haline getirmek - grind the wheat into flour - no hint
kim yardım edecek - who will help - no hint
inek buğdayı un haline getirmeme yardım eder misin - cow will you help me grind the wheat into flour - no hint
sağım zamanına çok yakın - it's too close to milking time - no hint
domuz buğdayı un haline getirmeme yardım eder misin - pig will you help me grind the wheat into flour - no hint
akşam yemeğine çok yakın - it is too close to suppertime - no hint
köpek buğdayı un haline getirmeme yardım eder misin - dog will you help me grind the wheat into flour - no hint
çok yakın - it is too close - no hint
yemek zamanı - suppertime - no hint
küçük kırmızı tavuk buğdayı tek başına un haline getirdi - so the little red hen ground the wheat into flour all by herself - no hint
küçük kırmızı tavuk karar verdi - the little red hen decided - no hint
ununu ekmek yapmak için - to bake her flour into bread - no hint
o karar verdi - she decided - no hint
arkadaşlarına bir şans daha vermek için - to give her friends another chance - no hint
bu unu pişirmeme kim yardım edecek - who will help me bake this flour - no hint
ekmek içine - into bread - no hint
bu unu ekmek yapmak - bake this flour into bread - no hint
nasıl pişireceğimi bilmiyorum - i don't know how to bake - no hint
bu unu pişir - bake this flour - no hint
köpek yardım edecek misin - dog will you help - no hint
değil - not - no hint
ben yemek yapmayı bilmiyorum - i not i i don't know how to bake - no hint
küçük kırmızı tavuk ekmeği pişirdi - the little red hen baked the bread - no hint
ne zaman yapıldı - when it was done - no hint
soğumasına izin verdi - she let it cool - no hint
bir süre - for a while - no hint
o bunu bilmeden önce - before she knew it - no hint
zaman geldi - the time came - no hint
kesmek - to cut - no hint
ve ekmeği ye - and eat the bread - no hint
etrafında seyir - looking around - no hint
o kimseyi görmedi - she didn't see anyone - no hint
bu ekmeği yememe kim yardım edecek merak ediyorum - i wonder who will help me eat this bread - no hint
yapacağım yapacağım - i will i will i will - no hint
hayır yapmayacaksın - no you won't - no hint
tüm işi yaptım - i did all the work - no hint
ödülleri alıyorum - i get the rewards - no hint
o işin - of that work - no hint
bu ekmek - this bread - no hint
