Turkish Now

hafif - light
akılı - intelligent
sinirli - angry
komik - funny
yoğun - busy
sakin - calm
sevimli - cute
koyu - dark
iğrenç - disgusting
memnuniyetsizlik - dissatisfied 
utanmış - embarrassed
ünlü - famous
bedava - free
tok - full
sert - hard	
hayat dolu - lively
kaba - mean
dar - narrow
ağrılı - painful
fakir - poor
rahatlatıcı - relaxing
aynı - same
korkunç - scary
ciddi - serious
kısa - short
yumuşak - soft
ekşi - sour
güçlü - strong
uzun - tall
susamış - thirsty
zayıf - weak
geniş - wide
her ne - whatever
Bihter - Hatice'nin arkadaşı
zulal - Bihter'in ablası
kübra - Bihter ve zülal'in kuzeni
yirmi - twenty
otuz - thirty
kırk - forty
elli - fifty
altmış - sixty
yetmiş - seventy
seksen - eighty
doksan - ninety
bin - thousand
milyon - million
aslında - actually
on buçuk gibi - like ten thirty 
on bir gibi - like eleven
yaklaşık - about
sohbet ettik - we chatted
bu yüzden - thats why
bu yüzden biraz uzun sürdü - so it took a little while
volkan - hatice'nin erkek kardeşi
aleyna - volkan'ın kız arkadaşı
olcay - hatice'nin ağabeyi
onun ağabeyi - her older brother
yeni kahvaltı yaptık - we just ate breakfast
hadi ya - expression that means you are amazed to hear something
annemgil - my parents
demiştim ya - i told you
davet ettiğin için teşekkürler - thanks for inviting me
gelmeme izin verdiğin için teşekkürler - thanks for letting me come
olcay'ın sevgilisinin adıne? - what is olcay's girlfriend's name?
adın ne? - what is your name?
are you free? - boş musunuz?
zeki - clever
Şuan uyanığım - i am awake now
çok garip bir rüya gördüm - i had a very weird dream
otobüs kartına para koyacağım - i will put money on the bus card
dışarı çıktığımda - when i go out
bu arada - by the way
O yüzden kendin ile iyi vakit geçirdiğini düşünüyorum - then i think you had a good time with yourself
sana nereye gittiğimi söyleyeceğim - i will tell you where i go
aliye - Hatice'nin ablası
onun oğlu - his son
oğul - son
senin oğlun - your son
ebeveynler - parents
onun ebeveynleri - his parents
senin ebeveynlerin - your parents
üvey anne - step mother
üvey baba - step father
üvey kız kardeş - step sister
üvey erkek kardeş - step brother
damat - son in law
gelin - daughter in law
yenge - sister in law
enişte - brother in law
kuzen - cousin
yeğen - niece or nephew
karı - wife
koca - husband
teyze - maternal aunt
dayı - maternal uncle
anneanne - maternal grandmother
hala - paternal aunt
amca - paternal uncle
babaanne - paternal grandmother
kaynana - mother in law
kayınbaba - father in law
dede - grandfather
torun - grandchild
Aliye - Hatice'nin ablası
eh - um 
eh aslında - um actually
ha - oh
hm - hm
öf - uh
öf gene - uh again
ya - really
Şuan uyanığım - i am awake now
çok garip bir rüya gördüm - i had a very weird dream
otobüs kartına para koyacağım - i will put money on the bus card
dışarı çıktığımda - when i go out
bu arada - by the way
O yüzden kendin ile iyi vakit geçirdiğini düşünüyorum - then i think you had a good time with yourself
sana nereye gittiğimi söyleyeceğim - i will tell you where i go
Ünzile - olcay'ın nişanlısı
Ünzile - olcay'ın karısı
Hikmet abi - Hatice'nin babası
Kifayet abla - hatice'nin annesi
Tugay - hatice'nin düşünceli iş arkadaşı
Nurcan - hatice'nin işinde sekreter
Abdullah - hatice'nin iş arkadaşı
Kamil - Hatice'nin patron 
Özlem - Hatice'nin işinde temizlikçi
Jallow - hatice'nin afrikadan arkadaşı
nasılsın gardaş / kardeş - what's up bro
Kına gecesi - party before the wedding 
Düğün - wedding
Manisa - Olcay ve Ünzile'nin düğününün olacağı şehir