çünkü bulaşık deterjanı almaya giderken telefonumdan arnavutça dersi dinliyorum ve yirmiiki dakikası kaldı - porque estoy escuchando una lección de albanés en mi teléfono camino a comprar jabón para platos y me quedan veintidós minutos - because i'm listening to an albanian lesson on my phone on the way to buy dish soap and i have twentytwo minutes left, 
alışkanlığımı kaybettim - perdí mi hábito - i lost my habit, A Lish can lick you into keeping habits
zihin açıklığı - claridad de mente - clarity of mind, A chick licks me and everything is clear
kırılmam - no me romperé - i won't break, A cruel ill mom will never break
belgesel - documental - documentary, A documentary about a bell geese sell
amuda kalkıyorum - haciendo una parada de manos - doing a handstand, A mood a... Changes when you are in a handstand
dik - empinado - steep, A steep dick
bu normalin tersi - esto es lo contrario de lo normal - this is the opposite of normal, A ter see is the opposite of a sitter
maceralarla dolu rüyalar görürsün inşallah - espero que tengas sueños llenos de aventuras - i hope you have dreams full of adventures, Adventuresly full of
şu anda baş aşağıyım - estoy al revés en este momento - i'm upside down right now, Ah sh** I'm upside down
ahşap tahtalar - tablas de madera - wooden boards, Ah shop only deals with wood
umarım nereden aldığımı hatırlarım - espero recordar donde lo conseguí - i hope i remember where i got it, All dim in the place i got it
ışık anahtarları - interruptores de luz - light switches, Anna tars Larry when she flips the switch
omega üç arıyorum - buscando omega tres - looking for omega three, Are they here are the here, I'm looking everywhere
her zamankinden daha değişikti - fue diferente de lo habitual - it was different than usual, At this time more kin live in dens then ever before
balkabağı - calabaza - pumpkin, Ball ba.. it.. is not a ball, it's a pumpkin
banyo yapmaya ihtiyacım vardı - tuve que ir al baño - i had to go to the bathroom, Banyo.. yap my ahhh... I have to go to the bathroom
bezelye - guisantes - peas, Bayza ill ya, because she ate peas
bilerek - a propósito - on purpose, Be Leary of people who wreck things on purpose
değişikti - Era diferente - it was different, Because it was different, they each say ick
benim için sıkıntı değil - No es problema para mí - no problem for me, Being sick int a problem if you have a good immune system
göz önünde bulundurulduğunda - teniendo en cuenta - taking into account, Bull under old dune duh when it is kept here,
bahane - excusa - excuse, But honey... This is my excuse
kedi köpekten korkar - gato asustado del perro - cat afraid of dog, Cat from the dog is afraid
bana bir kaşık getirir misin lütfen - puedes traerme una cuchara por favor - can you bring me a spoon please, Cause shook didn't work we need a spoon
derinlerine - En el fondo de - deep into, Dare in Lear in deep into a hole,
not defteri - computadora portátil - notebook, Deaf terry would always have a notebook
düzelttiklerin için teşekkür ederim - gracias por corregir - thank you for correcting, Denzel Washington makes a check every time he corrects someone
dondurucu açık - congelador abierto - freezer open, Don put the freezer under you jew
keskin bir bıçak var mı - tienes un cuchillo afilado - do you have a sharp knife, Don't kiss skin with something sharp,
dört gözle bekliyorum - Estoy deseando que llegue - i'm looking forward to it, Fourward bu the eyes you look
fakat - pero - but, Fuck cat butt but don't really
türkiyenin geri kalanı - resto de pavo - rest of turkey, Garry call a nick to see if he has met the rest of turkey
su geçirmez - impermeable - waterproof, Getch ear mess keeps everything out
bir kase alıyorum - estoy tomando un tazón - i'm taking a bowl, Give me a bowl cause i say
havlular - toallas - towels, Have Lou a towel
çöpü alıp havluları değiştirdi - tomó la basura y cambió las toallas - took the trash and changed the towels, Have Lou some towels?
otelin havuzunu kullanacağım - Usaré la piscina del hotel - i will use the hotel pool, Have a zoo the new pool does
arka arkaya iki gün - Dos días seguidos - two days in a row, He built one ark after another ark, ya?
buranın kuzeyinde - al norte de aquí - north of here, Here's north
aşağı yukarı - más o menos - more or less, I'll show ya carry, more or less
bağımlıyım - soy adicto - i'm addicted, I'm addicted to ballin em and leavin em,
yani en azından bunu yapmalıyım - así que al menos debería hacer esto - so at least i should do this, If you are from the least then you are at least
eğer kendimi yazmaya zorlarsam - si me obligo a escribir - if i force myself to write, If you force yourself you can do difficult things
mıknatıslı dolap - gabinete magnético - magnetic cabinet, Micky mouses gnat is literally stuck to him like a magnet
böylelikle büyük bir daire oluşturdum - así que hice un gran círculo - so i made a big circle, Oh lush tour is the thing to create
aslında yazıyor olmam gerekir - en realidad debería estar escribiendo - i should actually be typing, Ole mom gets wrecked if i don't do what i am supposed to
uyandığımda - cuando me levanto - when i wake up, Oo yawn, the lights are dim, da.. this is how things are when you wake up
ulusal - nacional - national, Ooo lou saw the new national mandate
ama önümüzdeki haftanın sıcak olacakmış - pero la semana que viene va a hacer calor - but next week will be hot, Oooo new moos will be on the deck next week
öğrendiklerimden - de lo que aprendí - from what i learned, Or ren dick leary m Dan is from what I learned
basınç uyguluyorlar - ellos aplican presión - they apply pressure, Oy gauhl apply why they learn and practice şt
patlıcan - berenjena - aubergine, Pat little Jon on the head with an eggplan
buna dayanabilirim - puedo soportarlo - i can stand it, Princess Diana can stand anything
rastgele dolaşırım - deambulo al azar - i wander randomly, Rasta Man comes randomly
mektebe - a la escuela - to school, School you should make to be a good experience
sivrisinek - mosquito - mosquito, Seeve re sees nick to find out how to get rid of mosquitoes
iki şekilde yazacağım - lo escribiré de dos maneras - i will write it in two ways, She kills a day in many ways
dikkatimi dağıtacak - me distraerá - will distract me, Shu it will distribute your attention when you point your dick at me
sarımsak - ajo - garlic, Sir im sucking on your garlic
havlular buraya asılabilir - las toallas se pueden colgar aquí - towels can be hung here, Someone is hung by their asshole
yakında yemek yapacak mısın - vas a cocinar pronto - will you cook soon, Soon younwilş see ya kin dumb
temizlikçi - limpiador - cleaner, Ta me lick chair because the cleaner did such a good job
tadı çok güzeldi - el sabor era muy bueno - the taste was very good, Tada dıs taste is great
dağ tarafına doğru koştum - corrí hacia la ladera de la montaña - i ran towards the mountain side, Tear a fin off a fish
bunlar sayesinde daha fazla kart yapacağım - gracias a estos haré mas cartas - thanks to these i will make more cards, Thanks to these new holy books, sighing is a sin
duşumun küveti yok - mi ducha no tiene bañera - my shower doesn't have a tub, The animals do a voup to get the vet into a tub
reyhan - albahaca - basil, The basil should be in the sun ray hun
sen türkçe bellemişsen - si recuerdas turco - if you remember turkish, The bell misses when you remember something
basınç - presión - pressure, The boss inches closer to you to apply pressure
karo zemin - suelo de baldosas - tile floor, The car oh they mean tile the car floor
gözüme su kaçırmazlar - no me entran agua en los ojos - they don't get water in my eyes, The catcher misses things
çevresinde - alrededor - around, The chef resigned the paper over and over all around the place he was supposed to
çamaşır makinesi - lavadora - washing machine, The chum uh sheers the laundry
ellerimi kurutuyorum - me estoy secando las manos - i'm drying my hands, The core ought to be dry
onun bu kutuya ne peynir ne şeker koymasına izin ver - que no ponga ni queso ni azúcar en esta caja - let him put neither cheese nor sugar in this box, The coy ma sinner is in to bad things, don't let her put things into you
doğudaki dağlara doğru koştum - corrí hacia las montañas en el este - i ran towards the mountains in the east, The doe is with the ducky in the east
günün aydın olsun - que tengas un día brillante - have a bright day, The dog is intellectual and brightens up when he eyes din
banyo aynasının arkasında işiklar var - hay luces detrás del espejo del baño - there are lights behind the bathroom mirror, The eye know sin when you look in a mirror
fikrimi değiştireceğim - cambiaré de opinión - i will change my mind, The fee cream is on my mind
yüzme ile ilgili videolar - videos sobre natación - videos about swimming, The ill gill is related to the fishes sickness
panjurlar - persianas - shutters, The jury uses the window shutters
sana keyifli zamanlar diliyorum - te deseo un rato agradable - i wish you a pleasant time, The key if you live is to live pleasantly
gitmem lazım - tengo que ir - i have to go, The law of him is what has to be done
iniyordu - estaba descendiendo - was descending, The mood was decending in eyor dude
sunum - presentación - presentation, The presentation is so new hmmm
oldukça rahatlar - son bastante cómodos - they are quite comfortable, The raw hat is comfortable
rahatlat - relajarse - relax, The raw hat let me relax
yolculuğum güzeldi - mi viaje fue bueno - my journey was good, The way of jewels is the journey
tasarlanmış - diseñado - designed, The way the property is designed if you toss  (stuff onto) our lawn you will miss the stuff
dünya rekoru - récord mundial - world record, The world was here yesterday, ya?
yokuşlu - montañoso - hilly, The yolk uses the hillmto slide down
çamaşır makinesinin uzatma kablosuna ihtiyacı var - La lavadora necesita un cable de extensión. - washing machine needs extension cord, There are ooos at ma's extension
bir tencere getirir misin - puedes traer una olla - can you bring a pot, There are ten Jerry's in a pot
yazmam gerektiğini hatırladım - recordé que tenía que escribir - i remembered that i had to write, There is this teeny thing you remember you have to do
birkaç inek gördüm - vi algunas vacas - i saw a few cows, They give the cows e-necks
ilk defa soya küpleri aldım - compré cubos de soja por primera vez - i bought soy cubes for the first time, They keep the cubes all cooped up in a cube cage
bir sinek - una mosca - a fly, They see a fly on your neck
su koyda ıslansınlar - remojarlos en el agua - soak them in the water, Things get wet in Islans
hangi bölümden başlayacaksın - de que parte empezarás - which part will you start from, This is the part of the movie where a bowl looms over his head
iki kere yemek pişirdim - Cociné dos veces - i cooked twice, This piece here is cooked
bu sefer - esta vez - this time, This time Lucifer loses and bu sefer wins
karadağ'a geldiğimden beri - desde que vine a montenegro - since i came to montenegro, To Montengro from coming since
temizlik malzemeleri bu dolapta - los artículos de limpieza están en este armario - cleaning supplies are in this cupboard, To the mal ze mel goes to get materials
nereye gideceğimi bilmiyorum - no se a donde ir - i don't know where to go, To where i will go(object) i don't know
oruç tutmadığımda - cuando no estoy ayunando - when i'm not fasting, Toot ma dim duhhh when I'm not fasting
valla iyisin - bueno estas bien - well you are fine, Valla if you are fine
biz de dün ebrarı kırıkkaleye götürdük - ayer llevamos ebrar a kırıkkale - we took ebrar to kırıkkale yesterday, We took her to go tour a duck farm
hatırladığıma bakacağım - Veré lo que recuerdo - i will see what i remember, What i remember is that the hatter sand and was dim
düz ekran televizyon - televisión de pantalla plana - flat screen television, What the heck the screen ran all the way along the way,
vardığımda - cuando llegue - when i arrive, When i arrived there existed a dim guy, du
bu uzuyor - esto se hace más largo - this is getting longer, When it gets long it oozes
hava biraz soğumaya başladı - el clima se esta poniendo un poco frio - the weather is getting a little cold, When weather is getting cooler you ask yourself so who am I ya
neredeyse hiç - casi nunca - hardly ever, When you are near a day say you are almost to that day
neredeyse oradayım - estoy casi allí - i'm almost there, When you are near a day you say you are almost there
buzdolabı kapalı - refrigerador cerrado - refrigerator closed, When you cup a lip you close it
kiminle konuştuğumu bilmiyorum - no se con quien estoy hablando - i don't know who i'm talking to, Who i am talking to is a con man who used to be in a tomb
iyi yaşa - Salud - bless you, Yes our words are law
şimdi bulaşık yıkamaya gidiyordum - iba a lavar los platos ahora - i was going to wash dishes now, Yick! Ah my a messy thing I'm going to wash,
etrafta dolaştım - caminé alrededor - i walked around, You ate a raft as you walked around
burnuma biraz basınç - un poco de presión en mi nariz - a little pressure on my nose, You burn new ma on her nose
onun gelişimini izlemek zevkli - es divertido ver su progreso - it's fun to watch her progress, You come and progress up the chimney,
kalın perde - cubrir - drape, You get a new pair of curtains every day
nehire gittikten sonra markete gittim - fui al mercado después de ir al río - i went to the market after i went to the river, You go somewhere to get a tiki then after that you go somewhere else
sahile yakınım - estoy cerca de la playa - i am near the beach, You saw he lay at the beach
kendime zaman ayırdım - me tomé un tiempo para mí - i took time for myself, You seperate the eye from the ear
ben üşüyorum - Tengo frío - i'm cold, You shiver when you're cold
brüksel lahanası - coles de Bruselas - brussels sprouts, You sing while handing a sprout
birincisi tercümesiz ikincisi tercümeli - el primero es sin traducción el segundo es con traducción - the first is without translation the second is with translation, You tear a sentence in half (cüm)Le and the translation is inside
taşlı - rocoso - rocky, You toss rocks at tosh.0
bana yazdıklarını at - tírame lo que escribiste - throw me what you wrote, You wrote dicks in it
yorumunu sabırsızlıkla bekliyorum - espero tu comentario - i'm looking forward to your comment, You're uh moo new here, that is my comment,
yolun yarısındayım - estoy a mitad de camino - i'm half way, Your a sin damn, I'm halfway to you
boşnak böreği meşhur - la pastelería bosnia es famosa - bosnian pastry is famous, Your eyes bore a hole in the pastry,
yürümeye gidiyorum - voy a caminar - i'm going to walk, Your room may walk away
kızartma tavası var mı - tienes una sartén - do you have a frying pan, Your tough i see, can you bend a frying pan?
yarış - raza - race, Your wish is to win the race
işini düzelttikten - después de arreglar su trabajo - after you fix your job, after you fix your job
ayrıca - además - also, also
neyse - de todas formas - anyway, anyway
yatağa gitmeden - antes de ir a la cama - before going to bed, before going to bed
nefes tutma egzersizi - ejercicio para contener la respiración - breath holding exercise, breath holding exercise
hücreler - células - cells, cells
önce kötü hücreleri yer - primero come las células malas - eats bad cells first, eats bad cells first
oruç tutmadığım da - aunque no esté ayunando - even though i'm not fasting, even though i'm not fasting
her şey düşünüldu - todo ha sido considerado - everything has been considered, everything has been considered
oruç tutma - rápido - fasting, fasting
dilbilgisi - gramática - grammar, grammar
dil bilgisini - gramática - grammar, grammar
kadar yaygın olduğunu - que tan común es - how common it is, how common it is
basit cümleler kurabiliyorum - puedo formar oraciones simples - i can form simple sentences, i can form simple sentences
yazmadım - No escribí - i did not write, i did not write
yiyip içmedim - no comí ni bebí - i didn't eat or drink, i didn't eat or drink
nasıl kuracağımı bilmiyorum - no se como configurarlo - i don't know how to set it up, i don't know how to set it up
nefesimi tuttum - contuve la respiración - i held my breath, i held my breath
kiraladım - Alquilé - i rented, i rented
hatice'nin ailesiyle konuştum - hablé con la familia de hatice - i talked to hatice's family, i talked to hatice's family
sanırım oruç hakkında daha fazla konuşacağım - creo que hablaré más sobre el ayuno - i think i'll talk more about fasting, i think i'll talk more about fasting
ona yorgun olduğumu söyledim - le dije que estaba cansado - i told him i was tired, i told him i was tired
yazmaya devam edeceğim - seguiré escribiendo - i will continue to write, i will continue to write
onunla konuşuyorum - estoy hablando con el - i'm talking to him, i'm talking to him
üç saat oldu - han pasado tres horas - it's been three hours, it's been 3 hours
son cümle - última frase - last sentence, last sentence
hafıza - memoria - memory, memory
zihin - mente - mind, mind
dil bilgim zayıf - mis habilidades lingüísticas son deficientes - my language skills are poor, my language skills are poor
günlük - diario - journal, no hint
şekilde - camino - way, no hint
yazacağım - Escribiré - i will write, no hint
birincisi - primero - first, no hint
bir günlük başlatmak istiyorum - quiero empezar un diario - i want to start a diary, no hint
şu anda yunanistan atina'dayım - Actualmente estoy en Atenas, Grecia - i am currently in athens greece, no hint
dün bir bisiklet aldım - compré una bicicleta ayer - i bought a bike yesterday, no hint
planım kuzeye gitmek - mi plan es ir al norte - my plan is to go north, no hint
arnavutluk'u görmek istiyorum - quiero ver Albania - i want to see albania, no hint
sanırım arkadaşlarım savage ve chelsea almanya'da olacak ve onları görmek istiyorum - Creo que mis amigos Savage y Chelsea estarán en Alemania y quiero verlos. - i think my friends savage and chelsea will be in germany and i want to see them, no hint
herkese merhaba - Hola, todos - hello everyone, no hint
bu benim günlüğüm ve şimdi günüm hakkında yazacağım - este es mi diario y ahora escribiré sobre mi día - this is my diary and now i will write about my day, no hint
bu sabah bir kafede kahve içtim - tomé café en un café esta mañana - i had coffee in a cafe this morning, no hint
soğuk ve lezzetliydi - estaba frio y delicioso - it was cold and delicious, no hint
onu sevdim - me gustó - i liked it, no hint
oraya bisikletimle gittim - fui allí en mi bicicleta - i went there on my bike, no hint
oraya gitmeden önce rastgele dolaşırım ve kafenin nerede olduğunu bilmiyorum - antes de ir allí, deambulaba al azar y no sé dónde está el café - before i went there i wandered around randomly and i don't know where the cafe is, no hint
şimdi bunu bilgisayarımda yazıyorum ve biraz önce hatice ile konuştum - ahora estoy escribiendo esto en mi computadora y acabo de hablar con hatice - now i'm typing this on my computer and i just spoke to hatice, no hint
daha sonra bu cümleleri translate ile kontrol edeceğim - luego revisaré estas oraciones con traducir - later i will check these sentences with translate, no hint
üçüncü gün - día tres - day three, no hint
bugün yazamayacağımı düşünmüştüm ama bak işte buradayız - pensé que tal vez no escribiría hoy, pero mira aquí estamos - i thought i might not write today but look here we are, no hint
ben tembel değilim - no soy vago - i am not lazy, no hint
ancak belki bu sadece kısa bir giriş olacaktır - Sin embargo, tal vez esto sea solo una entrada breve. - however maybe this will just be a short entry, no hint
az da olsa birşeyler yazmak hiç yazmamakdan iyidir - Creo que una entrada corta es mejor que ninguna entrada. - i think a short entry is better than no entry, no hint
bugün erken saatlerde bisikletimi sürdüm - hoy más temprano monté mi bicicleta - earlier today i rode my bike, no hint
diğer günlere göre biraz daha fazla sürdüm - No monté mucho, pero monté más que cualquier otro día. - i didn't ride a lot but i rode more than every other day, no hint
bitirdim - terminé - i'm finished, no hint
kısa ve güzel - corto y dulce - short and sweet, no hint
bana mesaj attı - me envió un mensaje de texto - he texted me, no hint
kulağa iyi geliyor - suena bien - sounds good, no hint
karasız - inestable - unstable, no hint
kendine iyi bak - Cuídate - take care, no hint
bu benim planımdı - este era mi plan - this was my plan, no hint
nasıl sorarsın - como preguntas - how do you ask, no hint
ders çalışırım ya da plaja giderim - estudio o voy a la playa - i study or go to the beach, no hint
ders çalışacağım ya da plaja gideceğim - estudiaré o iré a la playa - i will study or go to the beach, no hint
kolay gelsin - buena suerte con - good luck with, no hint
allah zihin açıklığı versin - Dios te dé claridad - god give you clarity, no hint
iyi çalışmalar - buen trabajo - good work, no hint
o zaman - en ese caso - in that case, no hint
oruspu çocuğu - Hijo de puta - son of a bitch, no hint
belgesel - documental - documentary, no hint
telefonumdan - desde mi telefono - from my phone, no hint
giderken - muy activo - on the go, no hint
iradeyi güçlendirdiği - fortalece la voluntad - strengthens the will, no hint
mantar - champiñones - mushrooms, no hint
hokkabazlık yaptım - hice malabares - i juggled, no hint
coğrafya - geografía - geography, no hint
uçmak - mosca - fly, no hint
diğer günlere göre - en comparación con otros días - compared to other days, no hint
biraz daha fazla - un poco más - a little bit more, no hint
yazamayacağımı düşünmüştüm - pensé que no podía escribir - i thought i couldn't write, no hint
bak işte buradayız - mira aquí estamos - look here we are, no hint
arnavutluku görmek - ver Albania - see albania, no hint
bu cümleler - estas oraciones - these sentences, no hint
kontrol edeceğim - yo lo comprobare - i will check it, no hint
güzel bir gün geçirdim - tuve un buen día - i had a nice day, no hint
bunun hakkında konuşmak istiyorum - quiero hablar de eso - i want to talk about it, no hint
öğle yemeği için - para el almuerzo - for lunch, no hint
akşam yemeği için - para la cena - for dinner, no hint
ikisi de lezzetliydi - ambos somos deliciosos - both we're delicious, no hint
iki kere yüzdüm - nadé dos veces - i swam twice, no hint
bir tane sivrisinek - un mosquito - one mosquito, no hint
ingilizce yazacaktım - iba a escribir en ingles - i was going to write in english, no hint
bu sefer önce ingilizce yazacaktım unuttum - Olvidé que iba a escribir en inglés primero esta vez - i forgot i was going to write in English first this time, no hint
almaya giderken - en camino a conseguir - on the way to get, no hint
arnavutça dersi dinliyorum - estoy escuchando la lección de albanés - i'm listening to the albanian lesson, no hint
yirmiiki dakikası kaldı - Quedan veintidós minutos - twentytwo minutes left, no hint
düzeltmeler - corrige correcciones - fixes corrections, no hint
bütün gün - todo el dia - all day, no hint
kedi yerine köpeği al - conseguir el perro en lugar del gato - get the dog instead of the cat, no hint
zorlaştırmamak - no complicar - not to complicate, no hint
kolaylaştırdım - lo hice fácil - i made it easy, no hint
önceki - anterior - previous, no hint
önceki cümleyi - frase anterior - previous sentence, no hint
uzun sürdü - Llevó mucho tiempo - took a long time, no hint
çekmek - tirar - to pull, no hint
yaklaşık yedi - alrededor de las siete - about seven, no hint
gitmesine izin verdiler - lo dejaron ir - they let him go, no hint
eve geldikten sonra - después de llegar a casa - after coming home, no hint
mağazaya gittim - Fui a la tienda - i went to the store, no hint
tekrar eve geldim - volví a casa de nuevo - i came home again, no hint
biraz zaman alacak - tomará un poco de tiempo - it will take some time, no hint
durmalıyım - Tengo que parar - i have to stop, no hint
birkaç gündür günlük yazmadım - no he escrito un diario en unos días - i haven't written a diary for a few days, no hint
yolculuk - viaje - trip, no hint
ilk yarı - primera mitad - first half, no hint
engebeli - escabroso - rugged, no hint
gittiğimde - cuando voy - when i go, no hint
muhtemelen - probablemente - probably, no hint
kuzey - norte - north, no hint
olabilir - podría ser - it could be, no hint
bunu kısa tutacağım - Mantendré esto corto - i will keep this short, no hint
çevirdikten sonra - después de girar - after turning, no hint
sonrasında - después - after that, no hint
hazırladım - yo preparé - i prepared, no hint
yemek yerken - Mientras comé - while eating, no hint
zaman alacak - tomará tiempo - it will take time, no hint
ankara başkenttir - ankara es la capital - ankara is the capital, no hint
bir gölün yanındayım - estoy al lado de un lago - i'm next to a lake, no hint
sandalet - sandalias - sandals, no hint
oldukça aktifi - muy activo - very active, no hint
deniz gözlüğü - gafas de protección - goggles, no hint
dört gözle - esperar - look forward, no hint
burnuma - a mi nariz - to my nose, no hint
yolun yarışı - carrera de la carretera - race of the road, no hint
bir haftada - en una semana - in a week, no hint
bu yüzden kim bilir - entonces quien sabe - so who knows, no hint
bu yüzden - por lo tanto - therefore, no hint
çeviri yaptıktan sonra - después de traducir - after translating, no hint
daha çok yazacağım - escribiré más - i will write more, no hint
aktif - activo - active, no hint
açık hava - aire libre - open air, no hint
spor salonu - Gimnasio - gym, no hint
bisikletime bindim - me subí a mi bicicleta - i got on my bike, no hint
yaklaşık bir buçuk saat - alrededor de una hora y media - about an hour and a half, no hint
şehirde dolaştım - caminé por la ciudad - i walked around the city, no hint
yüzme gözlükleri - gafas de natación - swimming goggles, no hint
onları denedim - los probé - i tried them, no hint
tutarlar - cantidades - amounts, no hint
ağrılı - doloroso - sore, no hint
adında - llamado - named, no hint
yunanistan - Grecia - greece, no hint
dikkatim - mi atención - my attention, no hint
ne yapacağımı - qué hacer - what to do, no hint
oradayken - mientras estas ahí - while you are there, no hint
isteyeceğim - voy a querer - i will want, no hint
alamayabilirim - puede que no reciba - i may not receive, no hint
altın - oro - gold, no hint
metod - método - metod, no hint
sıfat - adjetivo - adjective, no hint
unuttuğum kelimeleri - palabras que olvidé - words i forgot, no hint
efenim - señor - sir, no hint
bana yazılar ver - dame mensajes de texto - give me texts, no hint
eksik bir kelime var - falta una palabra - there is a missing word, no hint
gitmeye hazırım - Estoy listo para irme - i'm ready to go, no hint
belgisiz - no notificado - unmarked, no hint
plaj - playa - beach, no hint
hamak - hamak - hamak, no hint
durum - situación - situation, no hint
günlük tutuyorum - llevo un diario - i keep a diary, no hint
en iyi sensin - Eress el mejor - you are the best, no hint
bence yaygın - creo que es común - i think it's common, no hint
bitmedi - no ha terminado - it's not over, no hint
mümkün - posible - possible, no hint
sadece on yaşındaki çocuklar için - solo para niños de diez años - only for ten year olds, no hint
küçük çocuklar için - para niños pequeños - for young children, no hint
daha karpuz kesecektik - vamos a cortar mas sandias - we we're going to cut more watermelons, no hint
bulaşık deterjanı - jabón para platos - dish soap, no hint
oruç tuttuğumda - cuando ayuno - when i fast, no hint
göz önünde - en vista - in view, no hint
ödlek - cobarde - coward, no hint
stil - estilo - style, no hint
mezar - tumba - grave, no hint
sorumluluk - responsabilidad - responsibility, no hint
beklediğimden daha fazla - más de lo que esperaba - more than i expected, no hint
uzun bir koşuya çıktım - fui por una carrera larga - i went for a long run, no hint
on kilometre koşarım diye planlandım - planeaba correr diez kilómetros - i planned to run ten kilometers, no hint
on altı kilometreden biraz fazla koştum - corrí un poco más de dieciséis kilómetros - i ran a little over sixteen kilometers, no hint
koştuğum yer - donde corro - where i run, no hint
dağa doğru koştum - corrí hacia la montaña - i ran towards the mountain, no hint
dağlara koştum - corrí a las montañas - i ran to the mountains, no hint
otelime gidiş yolundan farklı bir yoldan geldim - Vine por una ruta diferente a la de mi hotel - i came by a different route than the way to my hotel, no hint
böylelikle - por lo tanto - thus, no hint
daire - Departamento - apartment, no hint
oluşturdum - yo creé - i created, no hint
otele geldiğimde - cuando vengo al hotel - when i come to the hotel, no hint
balık ağı - red de pesca - fishing net, no hint
sayı - número - number, no hint
tablo - mesa - table, no hint
ayakta masa - escritorio de pie - standing desk, no hint
soğan - cebolla - onion, no hint
domates - Tomates - tomatoes, no hint
avokado - avokado - avokado, no hint
brokoli - brócoli - broccoli, no hint
tuz - sal - salt, no hint
gününe devam etmeye hazır mısın - ¿Estás listo para continuar tu día? - are you ready to continue your day, no hint
hayat sana güzel - la vida es buena contigo - life is good to you, no hint
kesin değil - no seguro - not certain, no hint
kasım - noviembre - november, no hint
türkiye'yi özledin mi ama doğruyu söyle - ¿Extrañaste el pavo pero di la verdad? - did you miss turkey but tell the truth, no hint
yarın doğum günü onun - mañana es su cumpleaños - tomorrow is her birthday, no hint
denize yakınım - estoy cerca del mar - i am near the sea, no hint
on kere on nedir - lo que es diez por diez - what is ten times ten, no hint
sabırsızlıkla - Impacientemente - impatiently, no hint
çöpü - basura - trash, no hint
geliştiriyor - se esta desarrollando - is developing, no hint
izlemek zevkli - divertido de ver - fun to watch, no hint
hatice ile çalışmayı bitirdikten sonra - después de que termines de trabajar con hatice - after you finish working with hatice, no hint
tarih - fecha o historia - date or history, no hint
matematiğin tarihçesi - historia de las matematicas - history of mathematics, no hint
kırk bir kelime ekledim - agregué cuarenta y una palabras - i added fortyone words, no hint
bitiriyorum - Estoy terminando - i'm finishing, no hint
önce ingilizce sonra türkçe - primero en inglés y luego en turco - first english and then turkish, no hint
yapmamam gerektiğini - que no debería - that i shouldn't, no hint
geçen birkaç gün - los últimos días - the past few days, no hint
anki kartları yaptım - hice las cartas anki - i made the anki cards, no hint
ağı olan balıkçılar - pescadores con una red - fishermen with a net, no hint
çok zamanını aldı - tomó mucho tiempo - took a lot of time, no hint
yakaladılar - atraparon - they caught, no hint
doğudaki dağlara - a las montañas del este - to the eastern mountains, no hint
iki hafta içinde - en dos semanas - in two weeks, no hint
pazar günü - domingo - sunday, no hint
pazartesi günü - lunes - monday, no hint
salı günü - martes - tuesday, no hint
çarşamba günü - miércoles - wednesday, no hint
perşembe günü - jueves - thursday, no hint
cuma günü - viernes - friday, no hint
cumartesi günü - sábado - saturday, no hint
döndü - regresó - returned, no hint
ocak - hogar - fireplace, no hint
şubat - febrero - february, no hint
mart - marcha - march, no hint
nisan - abril - april, no hint
mayıs - mayo - may, no hint
haziran - junio - june, no hint
temmuz - julio - july, no hint
ağustos - agosto - august, no hint
eylül - septiembre - september, no hint
ekim - octubre - october, no hint
aralık - rango o diciembre - range or december, no hint
çocuklara kim baktı - quien cuidaba a los niños - who looked after the children, no hint
dün selma onlara baktı - ayer selma los miró - yesterday selma looked at them, no hint
ağaçta neyi gördün erdoğan - que viste en el arbol erdogan - what did you see in the tree erdogan, no hint
ağaçta kediyi gördüm baba - vi al gato en el árbol papá - i saw the cat in the tree dad, no hint
kutuda ne buldun erdoğan - que encontraste en la caja erdogan - what did you find in the box erdogan, no hint
şekeri fincandan kim aldı - quien saco el azucar de la taza - who took the sugar from the cup, no hint
on kilometre koşmayı planladım - planeaba correr diez kilómetros - i planned to run ten kilometers, no hint
bulaşık mı kullanmıyorsunuz - no uses los platos - don't you use the dishes, no hint
sofrada yemeye alıştık - estamos acostumbrados a comer en la sábana tradicional - we are used to eating on the traditional sheet, no hint
fakir - pobre - poor, no hint
doydun mu - estás lleno - are you full, no hint
çok doydum - estoy tan lleno - i'm so full, no hint
çikolata yiyeceğim - comeré chocolate - i will eat chocolate, no hint
temizleyeceğim - Yo limpiaré - i will clean, no hint
bugün çok anki kart yaptım - Hice muchas tarjetas anki hoy - i made a lot of anki cards today, no hint
ama kaç tane bilmiyorum - pero no se cuantos - but i don't know how many, no hint
gidiyorum artık - me voy ahora - i'm leaving now, no hint
kahvesi meşhur - famoso por el café - famous for coffee, no hint
zemin - suelo - ground, no hint
kapı - portón - gate, no hint
koyu kahverengi kapı - puerta marrón oscuro - dark brown door, no hint
beyaz duvar - pared blanca - white wall, no hint
yeşil kanepe - sofa verde - green sofa, no hint
kağıt havlu - toalla de papel - paper towel, no hint
prizi - enchufe - socket, no hint
fırın - horno - oven, no hint
dondurucu kapalı - el congelador esta cerrado - the freezer is closed, no hint
lavabo - lavabo - washbasin, no hint
dolap - gabinete - cabinet, no hint
küçük beyaz lamba - pequeña lámpara blanca - small white lamp, no hint
ince perde - cortina transparente - sheer curtain, no hint
bar sandalyesi - silla de bar - bar chair, no hint
modem - módem - modem, no hint
klima çok iyi çalışıyor - el aire acondicionado funciona muy bien - air conditioner works very well, no hint
filmi durduruyorum - paro la pelicula - i stop the movie, no hint
aç olduğum için yemek yiyorum - como porque tengo hambre - i eat because i'm hungry, no hint
çöpü çöpe atıyorum - tiro la basura - i throw the trash away, no hint
filme başlamalı mıyım - ¿Debo empezar la película? - should i start the movie, no hint
yemek alıyorum bir şey ister misin - estoy consiguiendo comida ¿quieres algo? - i'm getting food do you want something, no hint
bu film çok mu korkunç - ¿Es esta película tan aterradora? - is this movie so scary, no hint
bu film çok mu sıkıcı - ¿Es esta película tan aburrida? - is this movie so boring, no hint
başka bir şey izlemek ister misin - quieres ver algo mas - do you want to watch something else, no hint
bulaşıkları yıkamak zorunda değilsin sadece rahatla - no tienes que lavar los platos solo relájate - you don't have to do the dishes just relax, no hint
cidden onları beraber yıkayabiliriz gel otur - en serio, podemos lavarlos juntos, ven a sentarte - seriously we can wash them together come sit down, no hint
bulaşık yıkıyorum - estoy lavando los platos - i am washing the dishes, no hint
kanın başıma gittiğini hissediyorum - siento que la sangre se me sube a la cabeza - i feel the blood go to my head, no hint
hiçbir zaman ingilizce düşünmeyi zaman kaybı olarak görmedim - Nunca vi pensar en inglés como una pérdida de tiempo. - i never saw thinking in english as a waste of time, no hint
bu bitki sukulent - esta planta es suculenta - this plant is succulent, no hint
bu ne tür bir bitki bilmiyorum - no se que tipo de planta es esta - i don't know what kind of plant this is, no hint
bence bu bikti lavanta - creo que esta planta es lavanda - i think this plant is lavender, no hint
bu sanatsal bir lavabo - este es un fregadero artístico - this is an artistic sink, no hint
ellerini bu sabunla yıka - lávate las manos con este jabón - wash your hands with this soap, no hint
bu prizi çalişmıyor - este enchufe no funciona - this plug is not working, no hint
bu prizi bozuk - este enchufe está roto - this plug is broken, no hint
bu kutu güzel kokuyor - esta caja huele bien - this box smells good, no hint
tuvalette oturuyorum - estoy sentado en el inodoro - i'm sitting on the toilet, no hint
bu tuvalet kağıdı - este papel higiénico - this toilet paper, no hint
burası bisikletimi tuttuğum oda - esta es la habitación donde guardo mi bicicleta - this is the room where i keep my bike, no hint
şehre - A la ciudad - to the city, no hint
bugün ne mektebe gittim ne de şehre - no fui a la escuela ni a la ciudad hoy - i neither went to school nor to the city today, no hint
bugün ne okula gittim ne de şehre - no fui a la escuela ni a la ciudad hoy - i neither went to school nor to the city today, no hint
o halde - en ese caso - in that case, no hint
iyi çok ol - se muy bueno - be very good, no hint
yalnız bir şehir gördüm - solo vi una ciudad - i only saw one city, no hint
oraya beş altı defa gittim - fui allí cinco o seis veces - i went there five or six times, no hint
çok az kaldı - estoy casi allí - im almost there, no hint
geldim geldim - yo vine yo vine - i came i came, no hint
çok yaşa - Salud - bless you, no hint
ahmet gitti mi - se ha ido - has ahmed gone, no hint
ahmet mi gitti - se ha ido ahmed - is ahmed gone, no hint
kitabı size verdiler mi - te dieron el libro - did they give you the book, no hint
selma iki çocuğu gördü mü - Selma vio a los dos niños - did selma see the two children, no hint
niçin parayı bize vermediniz - ¿Por qué no nos diste el dinero? - why didn't you give us the money, no hint
gelsinler mi gelmesinler mi - deberían venir o no - should they come or not, no hint
ahmet niçin gelmesin - ¿Por qué no debería venir ahmet? - why shouldn't ahmet come, no hint
hiçbir şey içmedi - no bebí nada - didn't drink anything, no hint
hiç ankaraya gittiler mi - ¿alguna vez han estado en ankara? - have they ever been to ankara, no hint
gazeteyi babaya verdin mi - le diste el periódico a tu padre - did you give the newspaper to your father, no hint
odada ne buldun - que encontraste en la habitacion - what did you find in the room, no hint
orada hiçbir şey bulmadım - no encontré nada allí - i didn't find anything there, no hint
ahmet gazeteyi okusun mu okumasın mı - ¿Debería haber leído el periódico o no? - should ahmet read the newspaper or not, no hint
tuvaletimi yapıyorum - voy al baño - i'm going to the bathroom, no hint
bulaşık mı yıkıyorsun - estas lavando los platos - are you washing the dishes, no hint
neden masa kullanmıyorsunuz - ¿Por qué no usas la mesa? - why don't you use table, no hint
hiç istanbula gittiniz mi - Has estado alguna vez en Estanbul - have you ever been to istanbul, no hint
dün o mu geldi - vino ayer - did he come yesterday, no hint
dün mü geldi - vino ayer - did it come yesterday, no hint
dün geldi mi - vino ayer - did he come yesterday, no hint
o mu geldi - vino - did he come, no hint
geldi mi - vino - did he come, no hint
kız hiç gülmedi - la chica nunca se rio - the girl never laughed, no hint
hiç gitmedi mi - Nunca ido - never gone, no hint
radyo sahibi - propietario de radio - radio owner, no hint
radyonun sahibi - dueño de la radio - owner of the radio, no hint
ev sahibinizin radyosunu kimin otomobiline koydular - ¿A quién le pusieron el coche en la radio del propietario? - whose car did they put your landlord's radio in, no hint
halı - estado o alfombra - state or rug, no hint
kaşık mı çatal mı istersin - quieres una cuchara o un tenedor - do you want a spoon or a fork, no hint
bu tahta kaşığı kullanabiliriz - podemos usar esta cuchara de madera - we can use this wooden spoon, no hint
bir kase ister misin - quieres un cuenco - do you want a bowl, no hint
bana bir tabak getirir misin - puedes traerme un plato - can you bring me a plate, no hint
yatak odası - Cuarto - bedroom, no hint
yatak odam - mi dormitorio - my bedroom, no hint
onun yatak odası - su dormitorio - his bedroom, no hint
halının sahibi - el dueño de la alfombra - the owner of the carpet, no hint
halının bir sahibi - un dueño de la alfombra - an owner of the carpet, no hint
bir halının bir sahibi - dueño de una alfombra - an owner of a carpet, no hint
halıların sahibi - dueño de alfombras - owner of carpets, no hint
halıların bir sahibi - dueño de alfombras - an owner of carpets, no hint
halı sahibi - dueño de la alfombra - carpet owner, no hint
bir halı sahibi - dueño de una alfombra - owner of a carpet, no hint
halı sahipleri - propietarios de alfombras - carpet owners, no hint
halının iki sahibi - dos dueños de la alfombra - two owners of the carpet, no hint
iki halı sahibi - dos propietarios de alfombras - two carpet owners, no hint
bahçeni gördüler - vieron tu jardín - they saw your garden, no hint
bahçesini gördüler - vieron tu jardín - they saw your garden, no hint
onların bahçesini gördüler - vieron su jardín - they saw their garden, no hint
onların bahçelerini gördüler - vieron sus jardines - they saw their gardens, no hint
babasının evi istanbul'da - la casa de su padre está en estambul - his father's house is in istanbul, no hint
kız annesine güldü - la niña se rió de su madre - the girl laughed at her mother, no hint
kitabını buldu - encontró su libro - found his book, no hint
çocuklar annelerine baktılar - los niños cuidaron a su madre - the children looked after their mother, no hint
kitaplarını bulmadılar - no encontraron su libro - they didn't find their book, no hint
senin kitaplarını bulmadılar - no encontraron tus libros - they didn't find your books, no hint
parayı evlerinde buldu - encontró el dinero en su casa - found the money in their home, no hint
parayı onların evinde buldu - encontró el dinero en su casa - found the money in their house, no hint
parayı ahmedin ceplerinde buldu - encontró el dinero en los bolsillos de ahmed - he found the money in ahmed's pockets, no hint
çocuklarınız dün sabah ahmedin annesinin evinde iki saat kaldılar - sus hijos se quedaron en la casa de la madre de ahmet durante dos horas ayer por la mañana - your children stayed at ahmet's mother's house for two hours yesterday morning, no hint
küçük oğlunuzun ceplerinde ahmedin babasının beş lirasını buldum - Encontré las cinco liras del padre de Ahmet en los bolsillos de tu pequeño hijo. - i found ahmet's father's five liras in your little son's pockets, no hint
kendi kitabım - mi propio libro - my own book, no hint
kendi kitabı - propio libro - own book, no hint
kendi kitabın - tu propio libro - your own book, no hint
kendi kitabınız - tu propio libro - your own book, no hint
kendi kitapların - tus propios libros - your own books, no hint
kendi kitaplarımız - nuestros propios libros - our own books, no hint
kendi kitaplarınız - tus propios libros - your own books, no hint
onların kendi kitapları - sus propios libros - their own books, no hint
kendine geldi - el vino en si mismo - he came to himself, no hint
kendi kendine geldi - vino por su propia voluntad - he came of his own accord, no hint
baban kim - quien es tu padre - who is your father, no hint
şehrin suyu çok iyi - el agua de la ciudad es muy buena - city water is very good, no hint
babaları oraya girmesinler - no dejes que sus padres vayan allí - don't let their parents go there, no hint
halı sahibi parayı aldı - el dueño de la alfombra tomó el dinero - carpet owner took the money, no hint
türk alfabesi kolay - alfabeto turco facil - turkish alphabet easy, no hint
türk lisanı zor mü - ¿El idioma turco es difícil? - is turkish language difficult, no hint
ders odamız sıcak - nuestro salón de clases es cálido - our classroom is warm, no hint
ama hala türkçe öğrendiğim için sorun yok - pero está bien ya que todavía estoy aprendiendo turco - but it's okay since i'm still learning turkish, no hint
birkaç cümle yazmak uzun sürmüyor - no lleva mucho tiempo escribir algunas frases - it doesn't take long to write a few sentences, no hint
yazdığım ilk şey - lo primero que escribí - first thing i wrote, no hint
karadağ'ın başkentindeyim podgerisa - estoy en la capital de montenegro podgerisa - i am in the capital of montenegro podgerisa, no hint
bugün belki kestireceğim - tal vez hoy tome una siesta - maybe i'll take a nap today, no hint
sadece üç dört saat uyudum - solo dormí tres o cuatro horas - i only slept three or four hours, no hint
sadece ne kadar özel olduğunu bilmeni istiyorum - solo quiero que sepas lo especial que eres - i just want you to know how special you are, no hint
kesinlikle sana yeşil kart verecekler - definitivamente te darán una tarjeta verde - they will definitely give you a green card, no hint
bakabilir miyim - puedo mirar - may i look, no hint
bil bakalım ne oldu - adivina qué pasó - guess what happened, no hint
dört yere sordum ama hiç yok - pregunté cuatro lugares pero ninguno - i asked four places but none, no hint
zaten beyza ile misin - ya estas con beyza - are you already with beyza, no hint
panjurlar sıkışmış - persianas atascadas - shutters stuck, no hint
ders odamızda kimi buldunuz - a quien encontraste en nuestra sala de conferencias - who did you find in our lecture room, no hint
kardeşimin ev sahibi otomobilini babamın garajına koydu - el arrendador de mi hermano puso su coche en el garaje de mi padre - my brother's landlord put his car in my father's garage, no hint
otomobil beyoğlundan istanbul üniversitesine gitti - el automóvil pasó de beyoğlu a la universidad de estambul - the automobile went from beyoğlu to istanbul university, no hint
küçük kız kardeşinin çay fincanları güzel - las tazas de té de tu hermana pequeña son hermosas - your little sister's teacups are beautiful, no hint
ev sahibimin kendi evi istanbul caddesinde - la casa de mi anfitrión está en la calle Estambul - my host's own house is on istanbul street, no hint
oğlunun ayakları büyük - tu hijo tiene pies grandes - your son has big feet, no hint
küçük kardeşinin ismi ne - cual es el nombre de tu hermanito - what is your little brother's name, no hint
ahmedin kız kardeşi dün gece niçin kız kardeşlerinin evine gitmedi - ¿Por qué la hermana de Ahmed no fue a la casa de sus hermanas anoche? - why didn't ahmed's sister go to her sisters' house last night, no hint
hiç beyoğluna gittin mi - ¿Alguna vez has estado en beyoğlu? - have you ever been to beyoğlu, no hint
neredeyse bir hafta oldu yazmadım - no he escrito durante casi una semana - i haven't written for almost a week, no hint
bu sabah nehirde yüzdüm - nadé en el río esta mañana - i swam in the river this morning, no hint
eve geldiğimde onları pişirdim - los cociné cuando llegué a casa - i cooked them when i got home, no hint
şu anda programlama yapacağım - estoy programando ahora mismo - i'm programming right now, no hint
belki az yazarsam yarın daha çok yazarım - tal vez si escribo menos escribiré más mañana - maybe if i write less i will write more tomorrow, no hint
yazı yazmanın çok uzun ve zor olduğunu düşünmek istemiyorum - no quiero pensar que escribir es demasiado largo y difícil - i don't want to think that writing is too long and hard, no hint
ama kısa kısa yazarsam başka günler evet yazı yazabilirim diyebilirim kendime - pero si escribo brevemente puedo decirme a mí mismo que puedo escribir otros días - but if i write short i can say to myself that i can write on other days, no hint
fakat bu çok kısa olacak çünkü başka şeyler de yapmak istiyorum - pero esto será muy corto porque yo también quiero hacer otras cosas - but this will be very short because i want to do other things too, no hint
marketten yeni çıktım - acabo de salir del mercado - i just left the market, no hint
düştün mü - Caíste - did you fall, no hint
düş aldın mı - soñaste - did you dream, no hint
bahçelerine gördüler - vieron en su jardín - they saw in their garden, no hint
düş aldım - Tomé una ducha - i had a shower, no hint
duşta mıydın - estamos en la ducha - we're you in the shower, no hint
ıspanak - Espinacas - spinach, no hint
okumayı çok sever - le encanta leer - loves to read, no hint
o kitabı okumadan size verdim - te lo di sin leer ese libro - i gave it to you without reading that book, no hint
oraya gitmek çok zor - es muy dificil ir alli - it is very difficult to go there, no hint
ingilizcede bu söz ne demek - ¿Qué significa esta palabra en inglés? - what does this word mean in english, no hint
onu görmeye geldiler - vinieron a verlo - they came to see him, no hint
yüzmek bilmez - no puedo nadar - can't swim, no hint
ingilizcede bilmezler mi - ellos no saben ingles - don't they know english, no hint
postacı günde iki defa gelir - el cartero viene dos veces al día - the postman comes twice a day, no hint
ben eve gelir gelmez size telefon ettim - te llamé tan pronto como llegué a casa - i phoned you as soon as i got home, no hint
bu sabah onu okumadan bana verdi - me lo dio esta mañana sin leerlo - gave it to me this morning without reading it, no hint
son zamanlarda ne yapıyorsun - que estas haciendo ultimamente - what are you doing lately, no hint
buranın doğusunda - al este de aquí - east of here, no hint
buranın güneyinde - al sur de aquí - south of here, no hint
dağlık bir ülke mi - es un país montañoso - is it a mountainous country, no hint
yüzme gözlüklerimi gördün mü - has visto mis gafas de natación - have you seen my swimming goggles, no hint
birkaç dakika önce bisikletime bindim - hace unos minutos me subí a mi bici - a few minutes ago i got on my bike, no hint
kapının yanında tutuyorlar - lo mantienen junto a la puerta - they keep it by the door, no hint
sorunlar - problemas - problems, problems
dil öğrenmede gerçekten iyi - muy bueno aprendiendo idiomas - really good at learning languages, really good at learning languages,
bilim insanları - científicos - scientists, scientists
iyi ki varsın - tan contento de tenerte - so glad i have you, so glad i have you
iradeyi güçlendirdiği - fortalece la voluntad - strengthens the will, strengthens the will
kelimenin anlamını - el significado de la palabra - the meaning of the word, the meaning of the word
kumsala - a la playa - to the beach, to the beach
denize - al mar - to the sea, to the sea
gelenek - tradicion - tradition, tradition
iki paragraf - dos párrafos - two paragraphs, two paragraphs
irade - voluntad - will, will
yaratacaktı - crearía - would create, would create
daha uzun yazmak - escribir más - write longer, write longer
günlük yazarken - escribir un diario - writing a diary, writing a diary
çalışmayı bitirdin - terminaste de trabajar - you finished working, you finished working
yapmam gereken başka şeyler var - tengo otras cosas que hacer - i have other things to do, İ have to put gears on a can
filmi durdurmalı mıyım - ¿Debo detener la película? - should i stop the movie, İ should mull it over
kestirdim - Tomé una siesta - i took a nap, İ took a nap and kiss tear in a dream
buzdolabı açık - refrigerador abierto - refrigerator open, İce cabinet
eritecek - se derretirá - will melt, İf You Air it out, it will melt
barfiks çektim - hice un pullup - i did a pullup, İf the bar fix i can check if Tim will do a pull up
ilgili - relativa a - relating to, İl gill and li are all relating to each other
buranın batısında - al oeste de aquí - west of here, İn the West bat is sin
bu giderek uzuyor - esto se hace más largo - this is getting longer, İncreasingly people re getting in wrecks
bir haritaya baktım - miré un mapa - i looked at a map, İt is hard to eat a map
sarı tabure - taburete amarillo - yellow stool, İt is ok to bury the stool
ama sonra alışıyordum - pero luego me acostumbré - but then i got used to it, İt was weird when they said a Lish instead of a list, but then i got used to it
