Turkish Cognates

akademi - academy
akademik - academic (adj)
aksan - accent (n)
asit - acid (n)
aksiyon - action (n)
aktif - active
aktör - actor
aktris - actress
adaptasyon - adaptation
adres - address (details of a place)
avantaj - advantage
alarm - alarm (of burglary, fire etc)
albüm - album
alkol - alcohol
alkolik - alcoholic (n)
alternatif - alternative
amatör - amateur
ambulans - ambulance
analiz - analysis
anti - anti
antibiyotik - antibiotic - aunty be oh teek
antidemokratik - antidemocratic
antipati - antipathy
antipatik - antipathetic
arena - arena
aritmetik - arithmetic
astronot - astronaut
atlet - athlete
atletik - athletic
atmosfer - atmosphere - what is happening in the atmosphere is at most fair
alfabe - alphabet
apartman - apartment block
asistan - assistant (n)
ağustos - August
oto - auto
otobiyografi - autobiography
otomatik - automatic
otomobil - automobile
bakteri - bacteria
balkon - balcony
balon - balloon (n)
banka - bank (place for money)
bagaj - baggage (luggage)
bar - bar (place to drink in)
bariyer - barrier
basketbol - basketball (game)
bisiklet - bicycle (n)
bisküvi - biscuit (cookie)
biyoloji - biology
biyolojik - biological
bluz - blouse - which color blouses are the best? blues
blucin (=kot) - blue jeans
bot - boat
badigard - bodyguard
bomba - bomb (n)
bot - boot (shoe)
branş - branch (of a study)
bravo - bravo
büro - bureau
buton - button (of a machine; on a website)
kablo - cable (wire)
kakao - cacao
kafe - café
kamera - camera (for making films, TV programmes)
kamp - camp (n)
kampanya - campaign (n)
kampüs - campus
kanser - cancer
kantin - canteen (in a school, factory etc)
kapasite - capacity
kaptan - captain (sailor; team leader)
karavan - caravan (trailer)
karbonhidrat - carbohydrate
karbon - carbon
kart - card (n)
kariyer - career (n)
karnaval - carnival
katalog - catalog
kategori - category
Katolik - Catholic
santimetre - centimeter
seremoni - ceremony
şampiyon - champion (n)
kanal - channel (n)
kaos - chaos
karakter - character
kimya - chemistry
çikolata - chocolate
koro - chorus (n)
Hıristiyan - Christian
sigara - cigarette
sinema - cinema
sivil - civil (not part of the military or gov.)
klasik - classic (n, adj)
klinik - clinic
kulüp - club (for an activity or sport)
kahve - coffee
kola - cola
kolektif - collective (adj)
koleksiyon - collection (set/group)
koloni - colony
komik - comic (amusing)
komedi - comedy
komedyen - comedian
komite - committee
komünikasyon - communication
kompleks - complex
komplike - complicated (complex)
kompozisyon - composition (essay)
konsantrasyon - concentration
konsept - concept
konser - concert (music)
konferans - conference
kontrat - contract (n)
kontrol - control (n)
kopya - copy (n)
koridor - corridor
kostüm - costume
kuzen - cousin (a child of your uncle or aunt)
krem - cream (for the skin; colour)
krema - cream (of milk)
kredi - credit (n)
kredi kartı - credit card
kriz - crisis
kriter - criterion
kritik - criticism; critical (important; serious/worrying)
kristal - crystal
kültür - culture (n)
kültürel - cultural
dans - dance (n)
derece - degree
demokrasi - democracy
demokratik - democratic
depresyon - depression (mental illness)
dizayn - design (n)
detay - detail (n)
dedektif - detective
diyalog - dialogue
dijital - digital
diplomat - diplomat
diplomatik - diplomatic
dezavantaj - disadvantage
disk - disk/disc
diploma - diploma
direkt - direct (adj)
disiplin - discipline (n)
drama - drama
doktor - doctor (n)
doküman - document (n)
dolar - dollar
ekonomi - economy (n)
ekonomik - economic; economical
editör - editor
efor - effort
elektrik - electricity - electricity is electric
elektronik - electronic
empati - empathy
imparator - emperor - the emperor, him par a (golf) tour
ansiklopedi - encyclopaedia
enerji - energy
enerjik - energetic
ekipman - equipment
etik - ethic; ethics; ethical
etnik - ethnic (adj)
avro - euro (n)
egzersiz - exercise (activities for body)
egzotik - exotic
eksper - expert (n)
ekstra - extra
ekstrem - extreme (adj)
faktör - factor (n)
fakülte - faculty (of a university)
favori - favourite
federal - federal
federasyon - federation
film - film (movie)
final - final (n)
finans - finance (n)
finansal - financial
finiş - finish (n)
futbol - football (game)
form - form (n)
format - format (n)
formül - formula - this formula is only for mules
forum - forum
ful - full (adj)
fonksiyon - function (n)
fonksiyonel - functional
galaksi - galaxy
galeri - gallery
garaj - garage (=carport)
gaz - gas (n)
jandarma - gendarme
general - general (in the army)
genel - general (adj)
jenerasyon - generation
centilmen - gentleman (a man who is always polite)
jest - gesture (n)
coğrafya - geography
geometri - geometry
geometrik - geometric
global - global
gol - goal (in football)
golf - golf
gram - gram/gramme
gramer - grammar
grup - group (n)
gri - grey
garantili - guaranteed (adj)
garanti - guarantee (n)
gitar - guitar
jimnastik - gymnastics
habitat - habitat
hol - hall (hallway)
hamburger - hamburger
harmoni - harmony
helikopter - helicopter
alo - hello (when answering the phone)
hobi - hobby
hokey - hockey
onur - honour (n)
otel - hotel
hipotez - hypothesis
ideal - ideal
idealist - idealist
ideoloji - ideology
ideolojik - ideological
illegal - illegal (adj)
illüzyon - illusion
illüzyonist - illusionist
imaj - image (public opinion)
indeks - index (n)
endirekt - indirect
enfeksiyon - infection
enstrüman - instrument (of music)
entegrasyon - integration
enternasyonal - international (adj)
İnternet - Internet
endüstri - industry - the industry end dus tree
endüstriyel - industrial
enflasyon - inflation (in prices)
enformasyon - information
enstitü - institute (n)
ironi - irony
ironik - ironic
İslâm - Islam
 ceket - jacket (for the body)
jet - jet (plane)
jüri - jury
şiş kebap - shish kebab/kabob
kilogram - kilogram/kilogramme
kilometre - kilometre/kilometer
Kur’an - Koran, Qur'an
laboratuvar - laboratory
lamba - lamp
lazer - laser
lider - leader
lig - league
legal - legal
limon - lemon
limonata - lemonade
liberal - liberal
lisans - licence (n)
limit - limit (n)
to list - listelemek
liste - list (n) - lists are canadian 'ey'
to lobby - lobi yapmak
lira - lira
litre - litre/liter
to mask - maskelemek
lobi - lobby (n)
to massage - masaj yapmak
lokal - local (adj)
makine - machine
magazin - magazine (of fashion, computer etc)
menajer - manager
manüel - manual (≠ automatic)
mart - March (the third month)
market - market (to buy things)
maske - mask (n)
masaj - massage (n)
maç - match (a sports event)
materyal - material (=materials)
matematik - maths/math
maksimum - maximum
mayıs - May (the fifth month)
mekanik - mechanics; mechanical
mekanizma - mechanism
madalya - medal (n)
medya - media
to get a message - mesaj almak
melodi - melody
to leave a message - mesaj bırakmak
menü - menu
to send a message - mesaj göndermek
to pass on a message - mesaj iletmek
mesaj - message
metafor - metaphor
metaforik - metaphorical
metal, metalik - metal, metallic
metropol - metropolis
metre - metre/meter
milimetre - millimetre/millimeter
milyon - million
to become a millionaire - milyoner olmak
milyoner - millionaire
mineral - mineral
mental - mental
metot - method
minimum - minimum
minibüs - minibus
mini etek - miniskirt
minibar - mini bar
mobil - mobile (adj)
model - model
to motivate - motive etmek - when you motivate, you make a motive
modern - modern
molekül - molecule
momentum - momentum
moral - morale
motivasyon - motivation
motor - motor (n)
müze - museum
müzik - music
müzikal - musical
müzisyen - musician - moo zee syen
Müslüman - Muslim
mit - myth
natürel - natural (not false or artificial)
negatif - negative
normal - normal
not - note (to remind you); notes (for studying)
nota - note (music)
nükleer - nuclear
numara - number (in a set/list; phone)
objektif - objective (adj)
ofis - office (a building; room)
olimpik - Olympic
Olimpiyat Oyunları - Olympic Games
opera - opera
operasyon - operation
operatör - operator (of a machine; a business)
organ - organ
organik - organic
to organize - organize etmek
organizasyon - organization
to panic - paniklemek
organize - organized
to park (vehicle) - park etmek
orijinal - original (not a copy; new)
oksijen - oxygen
to photocopy - fotokopi çekmek
paket - packet
panel - panel
panik - panic (n)
park - park (n)
partner - partner (n)
parti - party (for fun; in politics)
pasta - pasta
penaltı - penalty (in football)
pansiyon - pension (a small cheap hotel) - it is a cheap hotel, but it has a pan, see on the shelf
biber - pepper (n)
performans - performance
periyot - period (n)
perspektif - perspective
personel - personnel
fobi - phobia
fonetik - phonetic
fotokopi - photocopy (n)
fotoğraf - photograph (n)
to photograph - fotoğraf çekmek
fizik - physics
to picnic - piknik yapmak
piyano - piano
to plan - planlamak - you plan a simple song with one note (la)
piknik - picnic (n)
police officer - polis memuru
pilot - pilot (n)
pizza - pizza
plan - plan (n)
plastik - plastic
polis - police
poliçe - policy (of insurance)
politika - policy; politics
politik - politic; political
portre - portrait (n)
popüler - popular (liked by a lot of people)
pozisyon - position (n)
pozitif - positive
poster - poster
patates - potato
potansiyel - potential
paunt - pound (unit of money)
pratik - practical
pratik (n) - practice (n)
prezantasyon - presentation (to give a talk)
prens - prince
prenses - princess
prensip - principle
problem - problem
profesyonel - professional
profesör - professor (in a British university)
profil - profile (n)
program - programme/program (n)
proje - project (n)
prosedür - procedure
promosyon - promotion (the activity of advertising)
protein - protein
to protest - protesto etmek
protesto - protest (n)
protokol - protocol
psikoloji - psychology
psikolojik - psychological - something psychologic is peace combined with logic
risky - riskli
psikolog - psychologist
radikal - radical
rasyonel - rational
radyo - radio (for listening to music and news)
reaksiyon - reaction
realist - realist; realistic
realite - reality
reform - reform (n)
rejim - regime
rapor - report (a written/spoken description)
restoran - restaurant
ritim - rhythm
risk - risk (n)
robot - robot
roket - rocket (n)
rol - role
rol model - role model
romantizm - romance
romantik - romantic
rutin - routine
salata - salad
sandviç - sandwich (n)
sos - sauce
skandal - scandal
senaryo - scenario
skor - score (of a sport or game)
sektör - sector
sekreter - secretary
seküler - secular
selfie - selfie
seminer - seminar
servis - service (n)
seks - sex (activity)
seksi - sexy
şampuan - shampoo (n)
sinyal - signal (n) - i should give them the signal to let them know I've seen ya'll
şov - show (a performance for the public)
sosyal - social (adj)
spesifik - specific
spekülasyon - speculation
sponsor - sponsor (n)
to have sex - seks yapmak
spor - sport (n)
opposite sex - karşı cins
sprey - spray (n)
stadyum - stadium
standart - standard
to shampoo - şampuanlamak - you put shampoo on la(while you sing)
star - star (a famous performer/player)
istasyon - station (of train; radio)
şaşırtmak - to surprise
statü - status
şaşırmak - to be surprised
strateji - strategy
stratejik - strategic
stres - stress (feelings of worry or anxiety)
stüdyo - studio
sübjektif - subjective (objective)
şeker - sugar (n)
süper - super (adj, adv)
süpermarket - supermarket
sürpriz - surprise (n)
sembol - symbol
sembolik - symbolic
sempati - sympathy
sempatik - sympathetic
sistem - system
tablet - tablet
taktik - tactic, tactical
tank - tank
taksi - taxi
teknisyen - technician - to be a technician takes a neices yen
teknik - technique; technical
teknoloji - technology
teknolojik - technological
to telegraph - telgraf çekmek
telgraf - telegraph (n)
to telephone - telefon etmek
telefon - telephone (n)
teleskop - telescope
televizyon - television
tenis - tennis
terör - terror (violent action)
terörizm - terrorism
terörist - terrorist
test - test (medical; machine/product)
tekst - text (written material)
tip - tip (money)
tiyatro - theatre (to see plays)
terapi - therapy
terapist - therapist
teoloji - theology
teolojik - theological
teori - theory
teorik - theoretical
termometre - thermometer
tuvalet - toilet
tolerans - tolerance
domates - tomato
ton - ton
tur - tour (n)
turizm - tourism
turist - tourist
turnuva - tournament
trafik - traffic (n)
trajedi - tragedy
trajik - tragic
tren - train (railway)
transfer - transfer (n)
tropik - tropic
tropikal - tropical
tişört - t-shirt
tüp - tube (pipe for liquid)
tünel - tunnel (n)
TV - TV
tip - type (n) - a type of showing gratitude is to tip someone
üniforma - uniform (n)
ünite - unit (of a book)
üniversal - universal
üniversite - university
vazo - vase
versiyon - version
video - video (n)
virüs - virus
vizyon - vision
vizyoner - visionary
vitamin - vitamin
voleybol - volleyball
volüm - volume (sound; book)
yat - yacht




