TurkishAudio
canlı - alive - what Jan li(cks) Micheal, he feels alive
sinirli - angry - a sinner li(cks) someone when they are angry
kaygılı - anxious - flying a kite when saying goodbye(gule gule) makes me anxious
kötü - bad - it is bad to cut you
güzel - beautiful - The guzel is a beautiful animal
en iyi - best - if you are in good, you are the best
büyük - big
acı - bitter - you eat something spicy and you say want to say you need a juice, all you can say is "a ji--!"
sıkıcı - boring - you are bored so you are start skinning injins, ski ji
parlak - bright - the parlor is locked, but it is bright inside
yoğun - busy - when you are really busy you yawn alot
sakin - calm - They keep the baby calm by putting a sock in it's mouth
ucuz - cheap - ew, jews are so cheap
temiz - clean - tell me the court is clean enough for tenis
bulutlu - cloudy - it is cloudy, BUT we can still LOOT LOU
soğuk - cold - it is cold because I am soaked
serin - cool - A serene, cool, chilly night
sevimli - cute - same root of sevmek, to like/love. "eemly" is adjective sounding
koyu - dark - you run into dark and say "I am cool, you?"
lezzetli - delicious - Liz eats Lee and says he is delicious
farklı - different - a farklı is a little different from a forklift
zor - difficult - ZORo does difficult things
kirli - dirty - You cure lee from being dirty. Dirty curly hair.
iğrenç - disgusting - You rent a high tech "e-ranch", but it is disgusting
memnuniyetsiz - dissatisfied - you say you are glad to meet someone, yet (your) sis is better so you are dissatisfied
erken - early - our ken is always early
kolay - easy - my job is easy, it's cool I just lie here
utanmiş - embarrassed - You console an embarrassed lady and tell her "you tan miss"
heyecanlı - excited - You are excited and say "Hey John look!"
heyecan verici - exciting - You are in an exciting situation and you say "Hey John, (this is) very G"
pahalı - expensive - Pa hallers because something is so expensive
ünlü - famous - Lou can't undo being famous
uzak - far - oo, zach is so far away
yabancı - foreign - They tell the foreign person, "ya banned ji(ew)". Or you bungee jump when you are a foreigner
bedava - free - the bed have a free pillow with it
tok - full - you are so full you can't talk
komik - funny - the comic is funny
iyi - good
harika - great - It's great when you find gold so you say "harika" (yurika!)
mutlu - happy - you are happy because someone muted lou
sert - hard - You in(sert) the hard thing in
ağır - heavy - "ah er" is like a grunt sound you make picking up something heavy. air is really heavy.
yüksek - high - There is a Uke sec(t) of tall people on a high building
sıcak - hot - you see Jack is hot because he jumped over a candle stick
nemli - humid - there is a word to describe when there is moisture in the air, namely "humid"
aç - hungry - the tree(ağaç) is so hungry it says its name in a hurry
önemli - important - oh, humid(nemli) weather is very important for some plants
akıllı - intelligent - a killer must be very intelligent
ilginç - interesting - it would be very interesting if it turned out the grinch was ill, ilginç
nazik - kind - one kind nazi eeked thru 
büyük - large
geç - late - "getchur stuff, we're late"
hafıf - light - you only get half if you are a light person
hayat dolu - lively - The high hat do Lou when he is lively
uzun - long - you zoon a long time before you realise you should be on zoom
yüksek sesli - loud - high(yüksek) sound(ses)li
düşük - low - they shook the tree and it made all the fruit fall low to the ground
evli - married - mixed up evil(evli) people get married, it has that 'li' adjective ending
kaba - mean - A mean person gives a baby a cutting baba
dar - narrow - the narrow passage was so dark you couldn't see the last letter in dar(k)
yakın - near - it is good to keep ya kin near you
kaygılı - nervous - Kaius is nervous about getting gills
yeni - new - ya nee(d) new stuff all the time
iyi - nice - it is good to be nice
eski - old - A really old man says he wants to "eh.. ski"
ağrılı - painful - painful things are a le(sson)
fakir - poor - Someone is so poor they let someone fuck (their) ear
sessiz - quiet - sound + -siz(without/less suffix)
yağmurlu - rainy - ya murder someone in the rain(yağmur) + -lu(adjective ending). Do you drink wine when its rainy? "Ya, merlot"
rahatlatıcı - relaxing - someone tells me specifically that wearing a raw hat and singling will relax me, "raw hat la tj"
zengin - rich - those rich people, zey gain lots of stuff. 
doğru - right (correct) - Whichever door you pick will be the right one. Also means straight, as in straight ahead
üzgün - sad - The leaders of goons are asking each other whose goon is the sad one
tuzlu - salty - In you twos, you love salt(tuz) + -lu(adjective ending)
aynı - same - as you are dying you say "I ne--" to be the same as living people, but you die before finishing the word 'need'
memnun - satisfied - like in memnun odlum(pleased to meet you)
korkunç - scary - it would be scary if pick up an apple and the core crunches in the middle of it
ciddi - serious - Dee got a sex change, you accidently start to call her by her old name, Jim, but then you correct yourself Ji-Dee and everyone acts like this is a seriosu offense
kısa - short - you kiss a short person
utangaç - shy - it is similar to embarrassed(utanmiş), but with a "go w(atch)" like you are encouraging a shy person to go watch something
tek - single - tech people like to work alone. if you are the sole person here, nobody can take you.
küçük - small - the cool chick is really small
yumuşak - your cow (moo) is shocked to discover it is the softest cow in the world
ekşi - sour - "ek!" she says, "this is so sour!"
özel - special - a special person is like a beautiful person without the need for the extra g(lamour)
acı - spicy - you eat something spicy and you say want to say you need a juice, all you can say is "a ji--!"
güçlü - strong - A really strong guy wearing gucci and louis vuitton. If gucci and louis vuitton combined, they would be the strongest fashion company in the world!
güneşli - sunny -  day = gün, güneş = sun, -li = adjective suffix
emin - sure - "hey man, I am sure saying amen is appropriate"
tatlı - sweet - the toddler is very sweet
uzun - tall - it is too soon for you to be so tall so they get rid of your t. Also same word as long.
susamış - thirsty - Sammy Sosa misses the ball because he is so thirsty
yorgun - tired - someone says they're tired, so you tell them "You're goon"
doğru - true (correct) - Whichever door you pick will be the right/true one. Also means straight, as in straight ahead
çirkin - ugly - you cheer for ken because he has finally come out as being ugly
sıcacık - warm - similar to hot(sıcak), but with an extra 'ca' in the middle
zayıf - weak - The german says "you vill zie if you are weak"
genış - wide - Ganesh is the widest god
rüzgarlı - windy - the plot to take the girl in a dress out on a windy day is the "ruse garli(slightly altered code word for girl)
yanlıs - wrong - someone is telling you something that is wrong and so yawn(ing feels de)lic(ious) to show them you know they are wrong
genç - young - being late(geç) and young is very similar, you are late to existing if you are young
yetişkin - adult - when you are an adult, ya tish(tish) your kin
uçak - airplane - oo! they give us chalk on the airplane
kol - arm - it is cool to have tattoos on your arm
bebek - baby - you bekon the baby over to you
sırt - back - you wear a s(h)irt on your back
banyo - bathroom - just like in spanish
yatak - bed - ya tack was in my bed
yatak odası - bedroom - no hint
sığır eti - beef - because it is a proper meat, people say sir meat(eti)
bira - beer - the same word with an a on the end
bisiklet - bicycle - it is similar to bicycle, but more busy and with a klet(kleet)
tekne - boat - you should take (a) ne(t) on the boat
vücut - body - in the holocaust they would (view) the body of a (jew) and then sh(oot)
kitap - book - there is a key on top of the book
oğlan - boy - where is the boy? oh, lawn
erkek arkadaş - boyfriend - it is just male + friend
ekmek - bread - ek, do not make bread
otobüs - bus - like autobus
takvim - calendar - your futuristic calendar is just talking to a virtual machine
araba - car - the car are a bar
cep telefonu - cellphone - cep looks a lot like cell, just the second l is curved and attached to the first l
göğüs - chest - the ghost has a nice chest
tavuk - chicken - the chicken meat is tough, uk
çocuk - child - there is a child and you want to get away so you juke
saat - clock - you sat and watch the clock
giysi - clothing - the geese see you with your clothing and they are jealous
bulut - cloud - Bullets that seem french come out of a cloud. You shoot the cloud with a bullet and then you loot it.
kahve - coffee - it is so similar
bilgisayar - computer - the computer tells you that your bill (is) ghee sire
aşçı - cook - the cook sneezes in the food
kredi kartı - credit card - the T goes from the first word to the second
fincan - cup - the feen john loves cups
kız - daughter - she is your daughter 'cuz she is so little
bankamatik kartı - debit card - a debit card is a bank automatic card
doktor - doctor - very similar
elbise - dress - el busy woman wears a dress
çalışan - employee - similar to work
mühendis - engineer - my hand is tied, I have to be an engineer
baba - father - your father uses the baba to feed you
parmak - finger - I can make par with just one finger
balık - fish - the fish licks your ball
yiyecek - food - similar to yemek, but with a jek ending like you eject food from a plane
ayak - foot - your foot is a yak
arkadaş - friend - you tell your friend to dash to the ark because of the flood
meyve - fruit - maybe fruit is not so good for you
kız - girl - your cousin is a girl
kız arkadaş - girlfriend - literally girl + friend
el - hand - the letter L is written on your hand
kafa - head - in Turkey, religious people cover their head
helikopter - helicopter - very similar
otel - hotel - very similar
saat - hour - you sat for an hour
koca - husband - a horror book like kujo, but instead of a crazy dog it is a crazy husband
buz - ice - a bus made completely out of ice
ceket - jacket - very similar
mutfak - kitchen - a mute person can fuck in the kitchen and noone will hear
kuzu eti - lamb - the akuza mainly eats lamb
bacak - leg - he is supposed to jump over a candlestick, but jack doesn't have any legs
adam - man - if you remove the m(boobs) from the front of a madam, it becomes a man
yönetici - manager - someone says they are the manager, and someone else says "you not tj"
dakika - minute - the kicker is that there is only a minute left
sabah - morning - every morning is a sabath
anne - mother - anne is a good mothers name, or mother is on a long trip
motosiklet - motorcycle - very similar
hemşire - nurse - the nurse must sheer the hem to prepare for the doctor
pantolon - pants - the pants are all alone, same as spanish pretty much
kurşun kalem - pencil - an apple core has shown you a pencil, so you call them
tabak - plate - someone fastens a plate to your back
polis memuru - police officer - a police officer remembers you
domuz eti - pork - a doe moos so you do not eat it and instead you eat pork
programcı - programmer - pretty similar, but with a 'cı' ending
yağmur - rain - ya murder people in the rain
satis elemani - salesperson - salespeople think sad is alamony because then people can't buy things
tuz - salt - people in their twos like salt
saniye - second - you havn't seen your knee in a long time and now you get to see it for a second so you say yay!
gömlek - shirt - you lick gum off your shirt
ayakkabı - shoe - shoe cover
kar - snow - you drive your car in the snow
çorap - sock - it is a chore to wrap your foot so you just wear a sock
kanepe - sofa - there is a canopy of the sofa
erkek evlat - son - male child er.. keks are usually male, you have a lot of children in your house, ev
mide - stomach - me day has been ruined by a stomach ache
mağaza - store - the store in ma plaza
şeker - sugar - pretty similar, but sugar is in a shaker
güneş - sun - the god gunesh created the sun
taksi - taxi - pretty much the same
çay - tea - chai tea
öğretmen - teacher - the teacher says it is all right man
televizyon - televison - pretty much the same
bugün - today - this + day
yarın - tomorrow - you're in the future, it is tomorrow
tren - train - pretty much the same
sebze - vegetable - just vegetables in subs, ye!
su - water - you sue someone for not giving water
hafta - week - you hafta wait a week to see someone
eş - wife - esh backwards is she, and a backwards she is a wife
şarap - wine - you share wine with OP so they shut up
kadın - woman - a woman is kuttin in line
yıl - year - you'll see me next year
dün - yesterday - dün is just before the alphabet from gün
bu seni ilgilendirmez - it's none of your business! - no hint
beni yalnız bırak - leave me alone - no hint
gerçekten gerginim - I am really nervous - no hint
endişeliyim - I am worried - no hint
onu düşündüğümde çok üzgün hissediyorum - I am sad when I think of her - no hint
o acıtır - it hurts - no hint
o gerçekten çok üzgün hissediyor - he feels really sad - no hint
çok üzücü - it's so sad - no hint
o çok şaşırdı - he was surprised - you are surprised and someone hushes you, shush, and says someone will hear
nerdeyse vardık - we're almost there - no hint
pes etme - do not give up - someone is trying to piss at me and i tell them not to give up
o zordu ama biz başardık - it was tough, but we did it - pirates say that to achieve and overcome they must bash, ar!!
ben kötü bir ruh hali içindeyim - I am in a bad mood - no hint
gitmek istemiyor gibiyim - I do not feel like going - no hint
neredeyse yapmıştım - I almost made it - no hint
kesinlikle komik değil - it's not funny at all - no hint
iyi hissetmiyorum - I do not feel well - no hint
bence yapabilirsin - I think you can do it - no hint
buraya oturabilir miyim? - may I sit here? - no hint
biliyorum - I know - no hint
hangi renk? - what color is it? - no hint
internete bağlanamıyorum - I can't connect to the internet - no hint
nereye gitmek istersiniz - where would you like to go? - no hint
bir dakika bekleyiniz lütfen - hold on one moment, please - no hint
sizi sonra tekrar arayabilir mi - can he call you back? - you call someone to ask if they are a'ri(ght)
sonra tekrar deneyeceğim - I'll try back later - no hint
Haziran'da bir haftalık tatil talep etmek istiyorum - I'd like to request a week off in June - you go on holiday to astatue of tati that's teal. you request telepathy. 
lütfen yazınız - please write it down - no hint
bir battaniye alabilir miyim - can I have a blanket? - no hint
lütfen bir dakika bekleyin - wait a moment - no hint
sonraki durak nedir - whats the next stop? - literally, next stop what is
burada durun lütfen - stop here, please - no hint
ilk kavşaktan sağa dön - turn right at the first intersection - no hint
ikinci trafik ışıklarından sola dön - turn left at the second traffic light - no hint
bu yer nerde biliyor musunuz - do you know where this place is? - no hint
ne kadar sürer - how long will it take? - no hint
havuz bugün açık mı - is the pool open today? - no hint
bitirdin mi? - are you finished? - you are so angry that something is finished that you beat your own ear
araba ile gezmeye gitmek ister misin - want to go for a drive? - no hint
yürüyüş yolu harika - the hiking trail is great - literally walking way great, yürüyüş has same root of to walk, yürümek, but the ending switched to yüş bc it is describing something you use, yolu is from yol, you'll find your way
çiçekler açıyor - the flowers are blooming - no hint
futbol sever misin - do you like soccer? - no hint
kulağa harika geliyor - sounds great - no hint
ne yemek istersiniz - what do you feel like eating? - no hint
çok fazla yedim - I ate too much - no hint
tokum - I am full - no hint
bu o mu - is that it? - no hint
gerçekten çok iyi - it's really good - no hint
ne zaman açılıyor - what time does it open? - you want to know when a chill(irs) opens
nereye gidiyoruz - where are we going? - no hint
biraz süt alabilir miyim - can I have some milk? - no hint
hesap - check! - no hint
bu ne kadar - how much is it? - no hint
karidese alerjim var - I am allergic to shrimp - no hint
bu ne tür bir yemek - what kind of dish is this? - no hint
ne içmek istersiniz? - what would you like to drink? - no hint
bunu alıcam - I'll have this - no hint
bana da aynısından - same for me - no hint
lütfen oturun - please have a seat - no hint
beş kişilik bir masa - a table for five - no hint
biz birisi ile buluşuyoruz - we're meeting someone - no hint
neye benziyorlardı - what did they look like? - no hint
o kırmızı bit gömlek ve kot pantalon giyiyordu. - she was wearing a red shirt and jeans - no hint
Bu alan tehlikeli - this area is dangerous - there is an area around alan. it is dangerous to tell leek (t)a lee
kütüphanenin karşısındaki sokak - it's across the street from a library - no hint
Ingilizce konuşuyor musunuz - Do you speak english? - no hint
arama yapabilir miyim - Can I make a call? - no hint
Bunu nasıl düzeltebiliriz - how can we fix this? - no hint
bir yanlış anlaşılma var - there's been a misunderstanding - no hint
eğer birşeye ihtiyacın olursa beni ara - call me if you need anything - no hint
birşey ihtiyaciniz var mı - do you need anything? - no hint
bu akşam döneceğim - I'll be back tonight - no hint
şimdi gidiyorum - I am leaving now - no hint
tuvalet kağıdı yok - there is no toilet paper - no hint
televizyon çalışmıyor - the TV is not working - no hint
kahvaltı saat kaçta - what time is breakfast? - no hint
rezervasyonunuz var mı acaba - do you have a reservation? - no hint
bir rezervasyonum var - I have a reservation - no hint
kaç kişi acaba - how many people? - no hint
sadece Salı - it's only tuesday - no hint
bugün çarşamba - today is wednesday - no hint
Pazartesi haftanın en berbat günü - Monday is the worst day of the week - no hint
pazar olmuş bile - it's already Sunday - no hint
yarından sonraki gün Cuma - the day after tomorrow is Friday - no hint
bugün günlerden ne? - what day is it today? - no hint
otuz dakika içinde biter - it ends in thirty minutes - no hint
o burada akşam yedi gibi olacak - she'll be here by 7 p.m. - no hint
uçak akşam 8:45'de varacak - the flight will arrive at 8:45 p.m. - no hint
görünüşe göre oraya varmak yaklaşık otuz dakika daha fazla sürecek - it looks like it will take about 30 more minutes to get there - no hint
otuz dakika erken varacağız - we'll arrive 30 minutes early - no hint
o şimdi gidiyor - he is leaving now - no hint
Hadi yirmi dakika içinde gidelim - Let's leave in 20 minutes - no hint
altı gibi ayrılabilir miyiz - can we leave around six? - no hint
öğleden önce burada ol - be here before noon - no hint
neredeyse alacakaranlık - it's almost dusk - all a jack a(that) ran lick at dusk
gece yarısı - it's midnight - you are a sissy if you are afraid of midnight
öğle - it's noon - no hint
saat üç - it's three o'clock - no hint
saat kaç senin için iyi - what is a good time for you - no hint
bunu daha önce yaptın mı - have you done this before - no hint
boş zamanlarında ne yaparsın - what do you do in your spare time - no hint
ben gitar çalıyorum - I play the guitar - playing an instrument is work, but less complicated, çalmak
hobilerin ne - what is your hobby - no hint
kaybınız için çok üzgünüm. - I am sorry for your loss - no hint
tebrikler - congratulations - no hint
size içecek herhangi birşey getirebilirmiyim - can I get you anything to drink - no hint
lütfen, oturun - please, sit down - "oh to run" says the person who has to sit down
içeri gel - come in - you eat a cherry inside another cherry + gel(come)
çok düşüncelisin - that was so thoughtful of you - no hint
yapmamalıydın - you shouldn't have - no hint
hoşgeldiniz - welcome - no hint
hiç çocuğun var mı - do you have any kids - no hint
Amerikalıyım - I am American - no hint
tatile mi gidiyorsun - are you going on vacation - no hint
randevunuz var mı - do you have an appointment - no hint
hasta hissediyorum - I feel sick - no hint
nereye gitmek istersin - where do you want to go - no hint
harika görünüyorsun - you look great - no hint
daha sonra tekrar gelebilir misin - can you come back later - no hint
kusara bakmayın tamamen doluyuz - sorry, we're completely booked - no hint
biz sizi arayacağız - we'll give you a call - no hint
size bırakıyorum - I'll leave it up to you - no hint
su çok mu soğuk - is the water too cold - no hint
bu bize ilk gelişiniz mi - is this your first time with us - no hint
sevdin mi - do you like it - no hint
harika görünüyor - it looks great - no hint
bende para yok - I have no money - no hint
buraya gitmek istiyorum - I want to go here - no hint
bu yeri arıyorum - I am looking for this place - no hint
üç ile beş iş günü arasında sürer - it takes three to five business days - no hint
bir açıklama alabilir miyim lütfen - could I have a statement, please - no hint
para bozdurmak istiyorum - I'd like to exchange money - no hint
para çekmek istiyorum - I'd like to make a withdrawal - no hint
depozito yatırmak istiyorum - I'd like to make a deposit - no hint
lütfen burayı imzalayın - sign here please - you sign because him all lyin. imzalamak, hims all a signin everything
geri git - go back - no hint
bu hesabın yıllık ücreti var mı - are there any annual charges with this account - no hint
bir hesap açtırmak istiyorum - I'd like to open an account - no hint
bu aciyor mu - does this hurt - no hint
öksürüğüm var - I have a cough - no hint
karın ağrım var - I have a stomachache - no hint
baş ağrım var - I have a headache - no hint
ateşim var - I have a fever - no hint
doldu bile - it's already full - no hint
yaklaşık iki hafta - about two weeks - no hint
bir sorun mu var - is there something wrong - no hint
aile ziyareti için buradayım - I am here to visit family - no hint
iş için buradayım - I am here on business - no hint
Central Otel'de kalacağım - I'll stay at the central hotel - no hint
daha önce burada bulundunuz mu - have you ever been here before - no hint
cuma kar yağacak - it will snow on friday - no hint
yarın güneşli ve yağışlı olacak - tomorrow will be sunny with showers - no hint
yarın güneşli olacak - tomorrow will be sunny - no hint
kaç derece - what is the temperature - no hint
yazları sıcak mı - is it hot in the summer - no hint
kışın hava nasıl - what is the weather like in winter - no hint
akşam yoğun yağış olacak - there will be heavy rain in the evening - no hint
akşamüzeri gökgürültülü sağanak yağış olacak - there will be thunder storms in the afternoon - no hint
bir fırtına geliyor - a storm in coming - no hint
akşamüzeri yağmur yağacak - it will rain in the afternoon - no hint
ne kötü bir hava - what bad weather - you have a nice day if the weather is good. literally, what bad a weather
bütün gün yağmur yağdı - it's been raining all day - no hint
çok güzel bir gün - it's a beautiful day - no hint
ee yeni birşey var mı - so, what is new - no hint
buğün nereye gittin - where did you go today - no hint
yarın ne yapıyorsun - what are you doing tomorrow - no hint
günün nasıldı - how was your day - no hint
herkes nerede - where is everyone - no hint
akşam yemeğinde ne var - what is for dinner - no hint
üzgünüm - I am sorry - no hint
merak etme - do not worry - no hint
lütfen - please - no hint
beni affet lütfen - please forgive me - no hint
minnetkarım - I really appreciate it - no hint
teşekkür ederim - thank you - no hint
merhaba - hello - no hint
günaydın - good morning - no hint
güle güle - goodbye - no hint
ne zamandır görüşmüyoruz - long time no see - no hint
iyi akşamlar - good evening - no hint
beklettiğim için özür dilerim - sorry to keep you waiting - no hint
alo? - hello? - no hint
harika - awesome - no hint
leziz - delicious - no hint
severim - I like it - no hint
sevmem - I do not like it - no hint
nasılsın - how are you - no hint
tanıştığımıza memnun oldum - nice to meet you - no hint
ben iyiyim - I am good - no hint
saat kaç - what time is it - no hint
yardım edin - help - literally, help you make
tamam - it's ok - no hint
gerçekten mi - really? - no hint
bu nedir - what is it - no hint
nerelisin - where are you from - no hint
kaç yaşındasın - how old are you - no hint
telefon numaran ne - what is your phone number - no hint
bir şey değil, rica ederim - you're welcome - no hint
bu senin için - this is for you - no hint
nasılsın - how have you been - no hint
kendini evinde hisset - make yourself at home - no hint
bu zor - it's difficult - no hint
bir kez daha, lütfen - once again, please - no hint
anlamadım - I do not understand - no hint
daha yavaş, lütfen - slower, please - no hint
ben değiştim - I've changed - no hint
tekrar yapmayacağım - I won't do it again - no hint
bu haftasonu sinemaya gideceğim - this weekend I am going to the movies - no hint
bu haftasonu ne yapıyorsun - what are you doing this weekend - no hint
gelecek hafta zamanım var - I'll have time next week - no hint
ben bu hafta meşgulüm - I am busy this week - there was a mess a ghoul made so I am busy cleaning it up
başlamaya hazır mısınız - ready to start - no hint
çok yakışıklısın - you're handsome - no hint
seni seviyorum - I love you - no hint
harika zaman geçiriyorum - I am having a great time - no hint
dans etmek ister misin - would you like to dance - no hint
ben değildim - it wasn't me - no hint
bir araba kazası vardı - there was a car accident - no hint
onlar telefonumu aldı - they took my phone - no hint
o benim çantamdı - ?it was in my bag - no hint
o anahtarlarını kaybetti - she lost her key - no hint
burada benim iletişim bilgilerim bulunuyor - here is my contact number - no hint
bir doktara ihtiyacım var - I need a doctor - no hint
polisi ara - call the police! - no hint
fiş alabilir miyim lütfen - can I have a receipt, please? - no hint
bir poşet alabilir miyim lütfen - can I have a bag, please? - no hint
Bundan bir tane lütfen - I'll take one of this - no hint
şu nedir? - what is that? - no hint
bu nedir? - what is this? - no hint
Herhangi bir kimliğiniz var mı acaba - do you have any identification? - no hint
biz kazandık - we won - from kazanmak, if you win you get a new cousin
sen bunu hak ettin - you deserve it - no hint
tüm teşekkürlerim size - it's all thanks to you - no hint
bunbu yapamam - I can't do that - no hint
sakinleş! - calm down! - if you put a sock in you will be worked up less, you will calm down
burada ne yapıyorsun - what are you doing here? - no hint
dikkatli ol - be careful - no hint
onun hakkında hala düşünüyorum - I am still thinking about that - no hint
yüzde yüz eminim - I am 100% certain - no hint
şansim arttı - I got lucky - no hint
büyük bir şey değil - it's no big deal - no hint
onun söylediği kadar iyi değil - it's not as good as he says - no hint
utangaçım - I am shy - no hint
çok utandım - I am so embarassed - no hint
söylediğin korkunç birşey. - that's a terrible thing to say - literally, what you said terrible thing
bunun için zamanim yok - I do not have time for this - no hint
eğer söyleyecek birşeyin varsa, söyle. - if you got something to say, say it - no hint
kazası - accident - you should have an accident cuz i say so
çanta - bag - someone is carrying around a chanter in a bag
anahtar - key -  someone asks you if this key is yours and you say "uh.. not our key"
kaybetmek - to lose - kaius bets on something and loses
iletişim - contact - he let it seem like we were in contact / communication
bilgi - information - you get billed ghee for the information you got
bulunuyor - is located - the balloon is located here
ihtiyac - need - ET needs help because something is about to hit him, you quickly tell him he needs to dodge it "ET ya..odge"
aramak - to call - December(aralık) is the month where people call family. 
phones are an invention that allow us to call
fiş - receipt - you get a receipt for the fish you buy
poşet - bag - if you push it, your bag will fall
bundan - from this - daniel BOON got his power from this, being up at DAWN
kimlik - identification - kim is an octopus, she licks things to identify them
kazanmak - to win - your cousin wins because she is on the top of the mountain
hak etmek - to deserve - you deserve it because you made a hawk
tüm - all - the tomb is where we are all headed
dikkatli - careful - you have to be careful when you point your dick at lee
hakkında - about - if there is a hawk in da discussion, the discussion is about the hawk
hala - about - he is still out there hala ing
emin - certain - when you are certain of something, you pray for it and say amen
yüzde - percent - a percent is what part of a hundred something is
şansim - my luck - with my luck, i accidently picked up Shawn's sim card
arttı - has increased - art increases in value, from artmak
söylediği - he / she said
bunun için - for this - literally, this for
eğer - if - if there is no air we can not breath
varsa - if there is - if there is a varsity basketball team, i will play
ilgilendirmez - it is not relevant - an ill gill end there mess, but this is not relevant to what made the fishes mess
bırak - leave - trump tells bırak obama he has to leave office
gergin - nervous - i am nervous because the gears in my car are green
acımak - to hurt - has pain(acı) as its root, pain makes you sneeze
olmak - to be - to be is to be OLd
sahip olmak - to have - you see a heap of stuff and you want to have it
yapmak - to do - instead of doing stuff some people just yap about what they'll do
demek - to say - de people make words, they say stuff
söylemek - to say - you say you like soylent
açıklamak - to explain - when you explain something, you open(açık) the truth
duymak - to hear - when someone says(demek) something, you hear(duymak) something slightly different
gitmek - to go - you go geet something
bilmek - to know
almak - to take - you take all the stuff
almak - to buy - you buy all the stuff
görmek - to see - an eye(gör) is all gorey
gelmek - to come - you come gel
düşünmek - to think - you think it is too soon
bakmak - to look - you look back at something
istemek - to want - wanting things in (s)ystemic
kullanmak - to use - thats a cool lawn, can I use it?
bulmak - to find - you find your bull
anlatmak - to tell - you tell an lot of stuff to people
sormak - to ask - You ask someone about that thing they are sore about
çalışmak - to work - you work hard to get a chalis(h)
çalışmak - to study (non academic) - Studying is work
görünmek - to seem - It seems like the un sees(görmek) everything
hissetmek - to feel - You hiss at someone to show them how you feel
denemek - to try - you say(DE) what(NE) you will try. You try living in a den.
bırakmak - to leave - you leave your fake beer behind(bira is actually beer)
çağırmak - to call - you call someone over cha here
göstermek - to show - you show someone there is a ghost here
akademi - academy
akademik - academic
aksan - accent
asit - acid
aksiyon - action
aktif - active
aktör - actor
aktris - actress
adaptasyon - adaptation
adres - address (details of a place)
avantaj - advantage
alarm - alarm (of burglary, fire etc)
albüm - album
alkol - alcohol
alkolik - alcoholic
alternatif - alternative
amatör - amateur
ambulans - ambulance
analiz - analysis
anti - anti
antibiyotik - antibiotic - aunty be oh teek
antidemokratik - antidemocratic
antipati - antipathy
antipatik - antipathetic
arena - arena
aritmetik - arithmetic
astronot - astronaut
atlet - athlete
atletik - athletic
atmosfer - atmosphere - what is happening in the atmosphere is at most fair
alfabe - alphabet
apartman - apartment block
asistan - assistant
ağustos - August
oto - auto
otobiyografi - autobiography
otomatik - automatic
otomobil - automobile
bakteri - bacteria
balkon - balcony
balon - balloon
banka - bank (place for money)
bagaj - baggage (luggage)
bar - bar (place to drink in)
bariyer - barrier
basketbol - basketball (game)
bisiklet - bicycle
bisküvi - biscuit (cookie)
biyoloji - biology
biyolojik - biological
bluz - blouse - which color blouses are the best? blues
blucin (=kot) - blue jeans
bot - boat
badigard - bodyguard
bomba - bomb
bot - boot (shoe)
branş - branch (of a study)
bravo - bravo
büro - bureau
buton - button (of a machine; on a website)
kablo - cable (wire)
kakao - cacao
kafe - café
kamera - camera (for making films, TV programmes)
kamp - camp
kampanya - campaign
kampüs - campus
kanser - cancer
kantin - canteen (in a school, factory etc)
kapasite - capacity
kaptan - captain (sailor; team leader)
karavan - caravan (trailer)
karbonhidrat - carbohydrate
karbon - carbon
kart - card
kariyer - career
karnaval - carnival
katalog - catalog
kategori - category
Katolik - Catholic
santimetre - centimeter
seremoni - ceremony
şampiyon - champion
kanal - channel
kaos - chaos
karakter - character
kimya - chemistry
çikolata - chocolate
koro - chorus
Hıristiyan - Christian
sigara - cigarette
sinema - cinema
sivil - civil (not part of the military or gov.)
klasik - classic (n, adj)
klinik - clinic
kulüp - club (for an activity or sport)
kahve - coffee
kola - cola
kolektif - collective
koleksiyon - collection (set / group)
koloni - colony
komik - comic (amusing)
komedi - comedy
komedyen - comedian
komite - committee
komünikasyon - communication
kompleks - complex
komplike - complicated (complex)
kompozisyon - composition (essay)
konsantrasyon - concentration
konsept - concept
konser - concert (music)
konferans - conference
kontrat - contract
kontrol - control
kopya - copy
koridor - corridor
kostüm - costume
kuzen - cousin (a child of your uncle or aunt)
krem - cream (for the skin; colour)
krema - cream (of milk)
kredi - credit
kredi kartı - credit card
kriz - crisis
kriter - criterion
kritik - criticism; critical (important; serious/worrying)
kristal - crystal
kültür - culture
kültürel - cultural
dans - dance
derece - degree
demokrasi - democracy
demokratik - democratic
depresyon - depression (mental illness)
dizayn - design
detay - detail
dedektif - detective
diyalog - dialogue
dijital - digital
diplomat - diplomat
diplomatik - diplomatic
dezavantaj - disadvantage
disk - disk / disc
diploma - diploma
direkt - direct
disiplin - discipline
drama - drama
doktor - doctor
doküman - document
dolar - dollar
ekonomi - economy
ekonomik - economic; economical
editör - editor
efor - effort
elektrik - electricity - electricity is electric
elektronik - electronic
empati - empathy
imparator - emperor - the emperor, him par a (golf) tour
ansiklopedi - encyclopaedia
enerji - energy
enerjik - energetic
ekipman - equipment
etik - ethic; ethics; ethical
etnik - ethnic
avro - euro
egzersiz - exercise (activities for body)
egzotik - exotic
eksper - expert
ekstra - extra
ekstrem - extreme
faktör - factor
fakülte - faculty (of a university)
favori - favourite
federal - federal
federasyon - federation
film - film (movie)
final - final
finans - finance
finansal - financial
finiş - finish
futbol - football (game)
form - form
format - format
formül - formula - this formula is only for mules
forum - forum
ful - full
fonksiyon - function
fonksiyonel - functional
galaksi - galaxy
galeri - gallery
garaj - garage (=carport)
gaz - gas
jandarma - gendarme
general - general (in the army)
genel - general
jenerasyon - generation
centilmen - gentleman (a man who is always polite)
jest - gesture
coğrafya - geography
geometri - geometry
geometrik - geometric
global - global
gol - goal (in football)
golf - golf
gram - gram / gramme
gramer - grammar
grup - group
gri - grey
garantili - guaranteed
garanti - guarantee
gitar - guitar
jimnastik - gymnastics
habitat - habitat
hol - hall (hallway)
hamburger - hamburger
harmoni - harmony
helikopter - helicopter
alo - hello (when answering the phone)
hobi - hobby
hokey - hockey
onur - honour
otel - hotel
hipotez - hypothesis
ideal - ideal
idealist - idealist
ideoloji - ideology
ideolojik - ideological
illegal - illegal
illüzyon - illusion
illüzyonist - illusionist
imaj - image (public opinion)
indeks - index
endirekt - indirect
enfeksiyon - infection
enstrüman - instrument (of music)
entegrasyon - integration
enternasyonal - international
İnternet - Internet
endüstri - industry - the industry end dus tree
endüstriyel - industrial
enflasyon - inflation (in prices)
enformasyon - information
enstitü - institute
ironi - irony
ironik - ironic
İslâm - Islam
 ceket - jacket (for the body)
jet - jet (plane)
jüri - jury
şiş kebap - shish kebab/kabob
kilogram - kilogram / kilogramme
kilometre - kilometre / kilometer
Kur’an - Koran, Qur'an
laboratuvar - laboratory
lamba - lamp
lazer - laser
lider - leader
lig - league
legal - legal
limon - lemon
limonata - lemonade
liberal - liberal
lisans - licence
limit - limit
listelemek - to list
liste - list - lists are canadian 'ey'
lobi yapmak - to lobby
lira - lira
litre - litre / liter
maskelemek - to mask
lobi - lobby
masaj yapmak - to massage
local - lokal
machine - makine
magazin - magazine (of fashion, computer etc)
menajer - manager
manüel - manual (≠ automatic)
mart - March (the third month)
market - market (to buy things)
maske - mask
masaj - massage
maç - match (a sports event)
materyal - material (=materials)
matematik - maths/math
maksimum - maximum
mayıs - May (the fifth month)
mekanik - mechanics; mechanical
mekanizma - mechanism
madalya - medal
medya - media
mesaj almak - to get a message
melody - melodi
mesaj bırakmak - to leave a message
menü - menu
mesaj göndermek - to send a message
mesaj iletmek - to pass on a message
mesaj - message
metafor - metaphor
metaforik - metaphorical
metal, metalik - metal, metallic
metropol - metropolis
metre - metre / meter
milimetre - millimetre / millimeter
milyon - million
milyoner olmak - to become a millionaire
milyoner - millionaire
mineral - mineral
mental - mental
metot - method
minimum - minimum
minibüs - minibus
mini etek - miniskirt
minibar - mini bar
mobil - mobile
model - model
motive etmek - to motivate - when you motivate, you make a motive
modern - modern
molekül - molecule
momentum - momentum
moral - morale
motivasyon - motivation
motor - motor
müze - museum
müzik - music
müzikal - musical
müzisyen - musician - moo zee syen
Müslüman - Muslim
mit - myth
natürel - natural (not false or artificial)
negatif - negative
normal - normal
not - note (to remind you); notes (for studying)
nota - note (music)
nükleer - nuclear
numara - number (in a set / list; phone)
objektif - objective
ofis - office (a building; room)
olimpik - Olympic
Olimpiyat Oyunları - Olympic Games
opera - opera
operasyon - operation
operatör - operator (of a machine; a business)
organ - organ
organik - organic
organize etmek - to organize
organizasyon - organization
paniklemek - to panic
organize - organized
park etmek - to park (vehicle)
orijinal - original (not a copy; new)
oksijen - oxygen
fotokopi çekmek - to photocopy
paket - packet
panel - panel
panik - panic
park - park
partner - partner
parti - party (for fun; in politics)
pasta - pasta
penaltı - penalty (in football)
pansiyon - pension (a small cheap hotel) - it is a cheap hotel, but it has a pan, see on the shelf
biber - pepper
performans - performance
periyot - period
perspektif - perspective
personel - personnel
fobi - phobia
fonetik - phonetic
fotokopi - photocopy
fotoğraf - photograph
fotoğraf çekmek - to photograph
fizik - physics
piknik yapmak - to picnic
piyano - piano
planlamak - to plan - you plan a simple song with one note (la)
piknik - picnic
polis memuru - police officer
pilot - pilot
pizza - pizza
plan - plan
plastik - plastic
polis - police
poliçe - policy (of insurance)
politika - policy; politics
politik - politic; political
portre - portrait
popüler - popular (liked by a lot of people)
pozisyon - position
pozitif - positive
poster - poster
patates - potato
potansiyel - potential
paunt - pound (unit of money)
pratik - practical
pratik - practice
prezantasyon - presentation (to give a talk)
prens - prince
prenses - princess
prensip - principle
problem - problem
profesyonel - professional
profesör - professor (in a British university)
profil - profile
program - programme / program
proje - project
prosedür - procedure
promosyon - promotion (the activity of advertising)
protein - protein
protesto etmek - to protest
protesto - protest
protokol - protocol
psikoloji - psychology
psikolojik - psychological - something psychologic is peace combined with logic
riskli - risky
psikolog - psychologist
radikal - radical
rasyonel - rational
radyo - radio (for listening to music and news)
reaksiyon - reaction
realist - realist; realistic
realite - reality
reform - reform
rejim - regime
rapor - report (a written / spoken description)
restoran - restaurant
ritim - rhythm
risk - risk
robot - robot
roket - rocket
rol - role
rol model - role model
romantizm - romance
romantik - romantic
rutin - routine
salata - salad
sandviç - sandwich
sos - sauce
skandal - scandal
senaryo - scenario
skor - score (of a sport or game)
sektör - sector
sekreter - secretary
seküler - secular
selfie - selfie
seminer - seminar
servis - service
seks - sex (activity)
seksi - sexy
şampuan - shampoo
sinyal - signal - i should give them the signal to let them know I've seen ya'll
şov - show (a performance for the public)
sosyal - social
spesifik - specific
spekülasyon - speculation
sponsor - sponsor
seks yapmak - to have sex
spor - sport
karşı cins - opposite sex
sprey - spray
stadyum - stadium
standart - standard
şampuanlamak - to shampoo - you put shampoo on la (while you sing)
star - star (a famous performer / player)
istasyon - station (of train; radio)
şaşırtmak - to surprise
statü - status
şaşırmak - to be surprised
strateji - strategy
stratejik - strategic
stres - stress (feelings of worry or anxiety)
stüdyo - studio
sübjektif - subjective (objective)
şeker - sugar
süper - super (adj, adv)
süpermarket - supermarket
sürpriz - surprise
sembol - symbol
sembolik - symbolic
sempati - sympathy
sempatik - sympathetic
sistem - system
tablet - tablet
taktik - tactic, tactical
tank - tank
taksi - taxi
teknisyen - technician - to be a technician takes a neices yen
teknik - technique; technical
teknoloji - technology
teknolojik - technological
telgraf çekmek - to telegraph
telgraf - telegraph
telefon etmek - to telephone
telefon - telephone
teleskop - telescope
televizyon - television
tenis - tennis
terör - terror (violent action)
terörizm - terrorism
terörist - terrorist
test - test (medical; machine / product)
tekst - text (written material)
tip - tip (money)
tiyatro - theatre (to see plays)
terapi - therapy
terapist - therapist
teoloji - theology
teolojik - theological
teori - theory
teorik - theoretical
termometre - thermometer
tuvalet - toilet
tolerans - tolerance
domates - tomato
ton - ton
tur - tour
turizm - tourism
turist - tourist
turnuva - tournament
trafik - traffic
trajedi - tragedy
trajik - tragic
tren - train (railway)
transfer - transfer
tropik - tropic
tropikal - tropical
tişört - t-shirt
tüp - tube (pipe for liquid)
tünel - tunnel
TV - TV
tip - type - a type of showing gratitude is to tip someone
üniforma - uniform
ünite - unit (of a book)
üniversal - universal
üniversite - university
vazo - vase
versiyon - version
video - video
virüs - virus
vizyon - vision
vizyoner - visionary
vitamin - vitamin
voleybol - volleyball
volüm - volume (sound; book)
yat - yacht
olarak - as - no hint
ben - I - no hint
onun - his - no hint
bu - that - no hint
diye - he - no hint
oldu - was - no hint
için - for - no hint
üzerinde - on - no hint
vardır - are - no hint
ile - with - no hint
onlar - they - no hint
olmak - be - no hint
at - at - no hint
bir - one - no hint
var - have - no hint
Bu - this - no hint
dan - from - no hint
tarafından - by - no hint
sıcak - hot - no hint
kelime - word - no hint
ancak - but - no hint
ne - what - no hint
bazı - some - no hint
olduğunu - is - no hint
o - it - no hint
sen - you - no hint
veya - or - no hint
vardı - had - no hint
arasında - of - no hint
karşı - against - no hint
ve - and - no hint
bir - a - no hint
içinde - in - no hint
biz - we - no hint
can - can - no hint
üzerinden - out - no hint
diğer - other - no hint
vardı - were - no hint
hangi - which - no hint
do - do - no hint
onların - their - no hint
zaman - time - no hint
eğer - if - no hint
olacak - will - no hint
nasıl - how - no hint
dedi - said - no hint
bir - an - no hint
her - each - no hint
söyle - tell - no hint
yok - does - no hint
set - set - no hint
üç - three - no hint
istiyorum - want - no hint
hava - air - no hint
iyi - well - no hint
ayrıca - also - no hint
oynamak - play - no hint
küçük - small - no hint
son - end - no hint
koymak - put - no hint
ev - home - no hint
okumak - read - no hint
el - hand - no hint
liman - port - no hint
büyük - large - no hint
büyü - spell - no hint
ekleyin - add - no hint
hatta - even - no hint
arazi - land - no hint
burada - here - no hint
gerekir - must - no hint
büyük - big - no hint
yüksek - high - no hint
böyle - such - no hint
izleyin - follow - no hint
hareket - act - no hint
neden - why - no hint
sormak - ask - no hint
erkekler - men - no hint
değişim - change - no hint
gitti - went - no hint
ışık - light - no hint
tür - kind - no hint
kapalı - off - no hint
gerek - need - no hint
ev - house - no hint
resim - picture - no hint
denemek - try - no hint
bizi - us - no hint
tekrar - again - no hint
hayvan - animal - no hint
nokta - point - no hint
anne - mother - no hint
dünya - world - no hint
yakın - near - no hint
inşa - construction - no hint
öz - self - no hint
toprak - earth - no hint
baba - father - no hint
herhangi - any - no hint
yeni - new - no hint
iş - work - no hint
bölüm - part - no hint
almak - take - no hint
olsun - get - no hint
yer - place - no hint
yapılan - made - no hint
canlı - live - no hint
nerede - where - no hint
sonra - after - no hint
geri - back - no hint
küçük - little - no hint
sadece - only - no hint
yuvarlak - round - no hint
adam - man - no hint
yıl - year - no hint
geldi - came - no hint
gösterisi - show - no hint
her - every - no hint
iyi - good - no hint
bana - me - no hint
vermek - give - no hint
bizim - our - no hint
altında - under - no hint
adı - name - no hint
çok - very - no hint
ile - through - no hint
sadece - just - no hint
formu - form - no hint
cümle - sentence - no hint
büyük - great - no hint
düşünmek - think - no hint
demek - say - no hint
yardım - help - no hint
düşük - low - no hint
hat - line - no hint
farklı - differ - no hint
dönüş - turn - no hint
neden - cause - no hint
çok - much - no hint
Yani - mean - no hint
önce - before - no hint
hareket - move - no hint
sağ - right - no hint
çocuk - boy - no hint
eski - old - no hint
çok - too - no hint
aynı - same - no hint
diye - she - no hint
tüm - all - no hint
orada - there - no hint
zaman - when - no hint
yukarı - up - no hint
Kullanım - use - no hint
senin - your - no hint
yol - way - no hint
hakkında - about - no hint
birçok - many - no hint
onları - them - no hint
yazmak - write - no hint
would - would - no hint
gibi - like - no hint
bu - yüzden - no hint
bu - these - no hint
onu - her - no hint
uzun - long - no hint
yapmak - make - no hint
şey - thing - no hint
görmek - see - no hint
onu - him - no hint
iki - two - no hint
var - has - no hint
bak - look - no hint
daha - fazla - no hint
gün - day - no hint
olabilir - could - no hint
gitmek - go - no hint
gel - come - no hint
yaptım - did - no hint
numarası - number - no hint
ses - sound - no hint
hayır - no - no hint
en - most - no hint
insanlar - people - no hint
benim - my - no hint
üzerinde - over - no hint
bilmek - know - no hint
su - water - no hint
daha - than - no hint
çağrı - call - no hint
ilk - first - no hint
kim - who - no hint
mayis - may - no hint
aşağı - down - no hint
yan - side - no hint
oldu - been - no hint
Şimdi - now - no hint
bulmak - find - no hint
kafa - head - no hint
standı - stand - no hint
kendi - own - no hint
sayfa - page - no hint
gerekir - should - no hint
ülke - country - no hint
bulundu - found - no hint
cevap - answer - no hint
okul - school - no hint
büyümek - grow - no hint
çalışma - study - no hint
hala - still - no hint
öğrenmek - learn - no hint
bitki - plant - no hint
kapak - cover - no hint
gıda - food - no hint
güneş - sun - no hint
dört - four - no hint
arasında - between - no hint
devlet - state - no hint
tutmak - keep - no hint
göz - eye - no hint
asla - never - no hint
son - last - no hint
let - let - no hint
düşünce - thought - no hint
Şehir - city - no hint
ağaç - tree - no hint
çapraz - cross - no hint
çiftlik - farm - no hint
sert - hard - no hint
başlangıç - start - no hint
olabilir - might - no hint
hikaye - story - no hint
testere - saw - no hint
kadar - far - no hint
deniz - sea - no hint
çizmek - draw - no hint
sol - left - no hint
geç - late - no hint
run - run - no hint
yapamaz - don’t - no hint
süre - while - no hint
basın - press - no hint
yakın - close - no hint
gece - night - no hint
gerçek - real - no hint
hayat - life - no hint
az - few - no hint
kuzey - north - no hint
kitap - book - no hint
taşımak - carry - no hint
aldı - took - no hint
bilim - science - no hint
yemek - eat - no hint
oda - room - no hint
arkadaşı - friend - no hint
başladı - began - no hint
fikir - idea - no hint
balık - fish - no hint
dağ - mountain - no hint
dur - stop - no hint
bir - kez - no hint
baz - base - no hint
duymak - hear - no hint
at - horse - no hint
kesim - cut - no hint
emin - sure - no hint
izle - watch - no hint
renk - color - no hint
yüz - face - no hint
ahşap - wood - no hint
ana - main - no hint
açık - open - no hint
görünmek - seem - no hint
birlikte - together - no hint
sonraki - next - no hint
beyaz - white - no hint
çocuk - children - no hint
başla - begin - no hint
var - got - no hint
yürümek - walk - no hint
örnek - example - no hint
kolaylığı - ease - no hint
kâğıt - paper - no hint
grup - group - no hint
her - zaman - no hint
müzik - music - no hint
bunlar - those - no hint
ikisi - the two - no hint
işareti - mark - no hint
sık - stylish - no hint
mektup - letter - no hint
kadar - until - no hint
kilometre - mile - no hint
nehir - river - no hint
araba - car - no hint
ayaklar - feet - no hint
bakım - care - no hint
ikinci - second - no hint
yeterli - enough - no hint
düz - plain - no hint
kız - girl - no hint
olağan - usual - no hint
genç - young - no hint
hazır - ready - no hint
yukarıdaki - above - no hint
hiç - ever - no hint
kırmızı - red - no hint
listesi - list - no hint
olsa - though - no hint
hissetmek - feel - no hint
tartışma - talk - no hint
kuş - bird - no hint
yakında - soon - no hint
vücut - body - no hint
köpek - dog - no hint
aile - family - no hint
doğrudan - direct - no hint
poz - pose - no hint
bırakın - leave - no hint
şarkı - song - no hint
ölçmek - measure - no hint
kapı - door - no hint
ürün - product - no hint
siyah - black - no hint
kısa - short - no hint
rakam - numeral - no hint
sınıf - class - no hint
rüzgar - wind - no hint
soru - question - no hint
olur - happen - no hint
komple - complete - no hint
gemi - ship - no hint
alan - area - no hint
yarım - half - no hint
kaya - rock - no hint
sipariş - order - no hint
yangın - fire - no hint
güney - south - no hint
sorun - problem - no hint
parça - piece - no hint
söyledi - told - no hint
biliyordu - knew - no hint
geçmek - pass - no hint
beri - since - no hint
üst - top - no hint
bütün - whole - no hint
kral - king - no hint
sokak - street - no hint
inch - inch - no hint
çarpmak - multiply - no hint
hiçbir şey - nothing - no hint
ders - course - no hint
kalmak - stay - no hint
tekerlek - wheel - no hint
tam - full - no hint
kuvvet - force - no hint
mavi - blue - no hint
nesne - object - no hint
karar - decision - no hint
yüzey - surface - no hint
derin - deep - no hint
ay - moon - no hint
ada - island - no hint
ayak - foot - no hint
sistem - system - no hint
meşgul - busy - no hint
Test - test - no hint
kayıt - record - no hint
tekne - boat - no hint
ortak - common - no hint
altın - gold - no hint
mümkün - possible - no hint
düzlem - plane - no hint
başkasının - someone else - no hint
kuru - dry - no hint
acaba - wonder - no hint
gülmek - laugh - no hint
bin - thousand - no hint
önce - ago - no hint
koştu - ran - no hint
kontrol - check - no hint
oyunu - game - no hint
şekil - shape - no hint
eşit - equate - no hint
sıcak - hot - no hint
özledim - miss - no hint
getirdi - brought - no hint
ısı - heat - no hint
kar - snow - no hint
lastik - tire - no hint
getirmek - bring - no hint
evet - yes - no hint
uzak - distant - no hint
doldurun - fill - no hint
doğu - east - no hint
boya - paint - no hint
dil - language - no hint
arasında - among - no hint
ünitesi - unit - no hint
güç - power - no hint
kasaba - town - no hint
ince - fine - no hint
belirli - certain - no hint
uçmak - fly - no hint
düşmek - fall - no hint
kurşun - lead - no hint
ağlamak - cry - no hint
karanlık - dark - no hint
makine - machine - no hint
notu - note - no hint
bekleyin - wait - no hint
planı - plan - no hint
rakam - figure - no hint
yıldız - star - no hint
kutu - box - no hint
i - noun - no hint
alan - field - no hint
gerisi - rest - no hint
doğru - correct - no hint
yetenekli - able - no hint
kiloluk - pound - no hint
bitti - done - no hint
güzellik - beauty - no hint
sürücü - drive - no hint
durdu - stood - no hint
içeren - contain - no hint
ön - front - no hint
öğretmek - teach - no hint
hafta - week - no hint
nihai - final - no hint
verdi - gave - no hint
yeşil - green - no hint
oh - oh - no hint
hızlı - quick - no hint
geliştirmek - develop - no hint
okyanus - ocean - no hint
sıcak - warm - no hint
ücretsiz - free - no hint
dakika - minute - no hint
güçlü - strong - no hint
özel - special - no hint
zihin - mind - no hint
arkasında - behind - no hint
açık - clear - no hint
kuyruk - tail - no hint
üretmek - produce - no hint
gerçek - fact - no hint
uzay - space - no hint
duydum - heard - no hint
en iyi - best - no hint
saat - hour - no hint
daha iyi - better - no hint
gerçek - true - no hint
sırasında - during - no hint
yüz - hundred - no hint
beş - five - no hint
hatırlıyorum - remember - no hint
adım - step - no hint
erken - early - no hint
tutun - hold - no hint
batı - west - no hint
zemin - ground - no hint
faiz - interest - no hint
ulaşmak - reach - no hint
hızlı - fast - no hint
fiil - verb - no hint
şarkı - song - no hint
dinle - listen - no hint
altı - six - no hint
tablo - table - no hint
seyahat - travel - no hint
daha az - less - no hint
sabah - morning - no hint
on - ten - no hint
basit - simple - no hint
birkaç - several - no hint
ünlü - vowel - no hint
doğru - toward - no hint
savaş - war - no hint
koymak - lay - no hint
karşı - against - no hint
desen - pattern - no hint
yavaş - slow - no hint
merkezi - center - no hint
aşk - love - no hint
kişi - person - no hint
para - money - no hint
hizmet - serve - no hint
görünür - appear - no hint
yol - road - no hint
harita - map - no hint
yağmur - rain - no hint
kural - rule - no hint
idare - govern - no hint
Çek - pull - no hint
soğuk - cold - no hint
haber - notice - no hint
ses - voice - no hint
enerji - energy - no hint
avı - hunt - no hint
muhtemel - probable - no hint
yatak - bed - no hint
kardeş - brother - no hint
yumurta - egg - no hint
binmek - ride - no hint
hücre - cell - no hint
inanıyorum - believe - no hint
belki - perhaps - no hint
seçmek - pick - no hint
ani - sudden - no hint
saymak - count - no hint
kare - square - no hint
neden - reason - no hint
uzunluk - length - no hint
temsil - representation - no hint
sanat - art - no hint
konu - subject - no hint
bölge - region - no hint
boyut - size - no hint
değiştirmek - vary - no hint
yerleşmek - settle - no hint
konuşmak - speak - no hint
ağırlık - weight - no hint
genel - general - no hint
buz - ice - no hint
madde - matter - no hint
daire - circle - no hint
çifti - pair - no hint
dahil - include - no hint
bölmek - divide - no hint
hece - syllable - no hint
keçe - felt - no hint
büyük - grand - no hint
top - ball - no hint
henüz - yet - no hint
dalga - wave - no hint
bırakın - drop - no hint
kalp - heart - no hint
duyuyorum - am - no hint
mevcut - available - no hint
ağır - heavy - no hint
dans - dance - no hint
motor - engine - no hint
pozisyon - position - no hint
kol - arm - no hint
geniş - wide - no hint
yelken - sail - no hint
materyal - material - no hint
kesir - fraction - no hint
orman - forest - no hint
oturmak - sit - no hint
yarış - race - no hint
penceresi - window - no hint
mağaza - store - no hint
yaz - summer - no hint
tren - train - no hint
uyku - sleep - no hint
kanıtlamak - prove - no hint
yalnız - lone - no hint
bacak - leg - no hint
egzersiz - exercise - no hint
duvar - wall - no hint
catch - catch - no hint
dağ - mount - no hint
dilek - wish - no hint
gökyüzü - sky - no hint
kurulu - board - no hint
sevinç - joy - no hint
kış - winter - no hint
Cts - sat - no hint
yazılı - written - no hint
vahşi - wild - no hint
enstrüman - instrument - no hint
tuttu - kept - no hint
cam - glass - no hint
çim - grass - no hint
inek - cow - no hint
iş - job - no hint
kenar - edge - no hint
işareti - sign - no hint
ziyareti - visit - no hint
geçmiş - past - no hint
yumuşak - soft - no hint
eğlenceli - fun - no hint
parlak - bright - no hint
gaz - gas - no hint
hava - weather - no hint
ay - month - no hint
milyon - million - no hint
ayı - bear - no hint
bitirmek - finish - no hint
mutlu - happy - no hint
umut - hope - no hint
çiçek - flower - no hint
giydirmek - clothe - no hint
garip - strange - no hint
gitti - gone - no hint
ticaret - trade - no hint
melodi - melody - no hint
gezi - trip - no hint
ofis - office - no hint
almak - receive - no hint
satır - row - no hint
ağız - mouth - no hint
tam - exact - no hint
sembol - symbol - no hint
ölmek - die - no hint
en - az - no hint
sorun - trouble - no hint
bağırmak - shout - no hint
hariç - except - no hint
yazdı - wrote - no hint
tohum - seed - no hint
sesi - tone - no hint
katılmak - join - no hint
önermek - suggest - no hint
temiz - clean - no hint
molası - break - no hint
bayan - lady - no hint
avlu - yard - no hint
yükselecek - rise - no hint
kötü - bad - no hint
darbe - blow - no hint
yağ - oil - no hint
kan - blood - no hint
dokunma - touch - no hint
büyüdü - grew - no hint
yüzde - cent - no hint
karıştırmak - mix - no hint
takım - team - no hint
tel - wire - no hint
maliyet - cost - no hint
kaybetti - lost - no hint
kahverengi - brown - no hint
giymek - wear - no hint
bahçe - garden - no hint
eşit - equal - no hint
gönderildi - sent - no hint
seçim - choose - no hint
düştü - fell - no hint
uygun - fit - no hint
akış - flow - no hint
adil - fair - no hint
banka - bank - no hint
toplamak - collect - no hint
kaydetmek - save - no hint
kontrolü - control - no hint
ondalık - decimal - no hint
kulak - ear - no hint
başka - else - no hint
oldukça - quite - no hint
kırdı - broke - no hint
dava - case - no hint
orta - middle - no hint
öldürmek - kill - no hint
oğlu - son - no hint
göl - lake - no hint
an - moment - no hint
ölçek - scale - no hint
yüksek sesle - loud - no hint
bahar - spring - no hint
gözlemlemek - observe - no hint
çocuk - child - no hint
düz - straight - no hint
ünsüz - consonant - no hint
ulus - nation - no hint
Sözlük - dictionary - no hint
süt - milk - no hint
hız - speed - no hint
yöntem - method - no hint
Organ - organ - no hint
ödeme - pay - no hint
yaş - age - no hint
bölüm - section - no hint
elbise - dress - no hint
bulut - cloud - no hint
sürpriz - surprise - no hint
sessiz - quiet - no hint
taş - stone - no hint
küçücük - tiny - no hint
tırmanış - climb - no hint
serin - cool - no hint
dizayn - design - no hint
kötü - poor - no hint
çok - lot - no hint
deneme - experiment - no hint
alt - bottom - no hint
anahtar - key - no hint
demir - iron - no hint
tek - single - no hint
sopa - stick - no hint
düz - flat - no hint
yirmi - twenty - no hint
cilt - skin - no hint
gülümseme - smile - no hint
kırışık - crease - no hint
delik - hole - no hint
atlama - jump - no hint
bebek - baby - no hint
sekiz - eight - no hint
köy - village - no hint
karşılamak - meet - no hint
kök - root - no hint
satın - buy - no hint
yükseltmek - raise - no hint
çözmek - solve - no hint
metal - metal - no hint
olsun - whether - no hint
it - push - no hint
yedi - seven - no hint
paragraf - paragraph - no hint
üçüncü - third - no hint
Shall - shall - no hint
tutulan - held - no hint
saç - hair - no hint
tanımlamak - describe - no hint
aşçı - cook - no hint
zemin - floor - no hint
ya da - or - no hint
sonuç - result - no hint
yanmak - burn - no hint
tepe - hill - no hint
güvenli - safe - no hint
kedi - cat - no hint
yüzyıl - century - no hint
düşünmek - consider - no hint
tipi - type - no hint
hukuk - law - no hint
bit - bit - no hint
sahil - coast - no hint
kopya - copy - no hint
ifade - phrase - no hint
sessiz - silent - no hint
uzun boylu - tall - no hint
kum - sand - no hint
toprak - soil - no hint
rulo - roll - no hint
sıcaklık - temperature - no hint
parmak - finger - no hint
sanayi - industry - no hint
değeri - value - no hint
kavga - fight - no hint
yalan - lie - no hint
yendi - beat - no hint
heyecanlandırmak - excite - no hint
doğal - natural - no hint
görünüm - view - no hint
sense - sense - no hint
sermaye - capital - no hint
olmaz - won’t - no hint
sandalye - chair - no hint
tehlike - danger - no hint
meyve - fruit - no hint
zengin - rich - no hint
kalın - thick - no hint
asker - soldier - no hint
süreç - process - no hint
işletmek - operate - no hint
uygulama - practice - no hint
ayrı - separate - no hint
zor - difficult - no hint
doktor - doctor - no hint
lütfen - please - no hint
korumak - protect - no hint
öğlen - noon - no hint
kırpma - crop - no hint
çağdaş - modern - no hint
eleman - element - no hint
vurmak - hit - no hint
öğrenci - student - no hint
köşe - corner - no hint
parti - party - no hint
besleme - supply - no hint
kimin - whose - no hint
yerleştirmek - locate - no hint
halka - ring - no hint
karakter - character - no hint
böcek - insect - no hint
yakalandı - caught - no hint
dönemi - period - no hint
göstermektedir - indicate - no hint
radyo - radio - no hint
konuştu - spoke - no hint
atomudur - atom - no hint
insan - human - no hint
geçmişi - history - no hint
etkisi - effect - no hint
elektrik - electric - no hint
bekliyoruz - expect - no hint
kemik - bone - no hint
demiryolu - rail - no hint
hayal - imagine - no hint
sağlamak - provide - no hint
katılıyorum - agree - no hint
böylece - thus - no hint
nazik - gentle - no hint
kadın - woman - no hint
kaptan - captain - no hint
sanırım - guess - no hint
gerekli - necessary - no hint
keskin - sharp - no hint
kanat - wing - no hint
oluşturmak - create - no hint
komşu - neighbor - no hint
yıkama - wash - no hint
yarasa - bat - no hint
yerine - rather - no hint
kalabalık - crowd - no hint
mısır - corn - no hint
karşılaştırma - compare - no hint
şiir - poem - no hint
dize - string - no hint
çan - bell - no hint
bağlı - depend - no hint
et - meat - no hint
ovmak - rub - no hint
tüp - tube - no hint
ünlü - famous - no hint
dolar - dollar - no hint
akışı - stream - no hint
korku - fear - no hint
görüş - sight - no hint
ince - thin - no hint
üçgen - triangle - no hint
gezegen - planet - no hint
acele - hurry - no hint
baş - chief - no hint
koloni - colony - no hint
saat - clock - no hint
mayın - mine - no hint
kravat - tie - no hint
girin - enter - no hint
büyük - major - no hint
taze - fresh - no hint
arama - search - no hint
göndermek - send - no hint
sarı - yellow - no hint
gun - gun - no hint
izin - allow - no hint
baskı - print - no hint
ölü - dead - no hint
nokta - spot - no hint
çöl - desert - no hint
takım elbise - suit - no hint
akım - current - no hint
asansör - lift - no hint
gül - rose - no hint
varmak - arrive - no hint
usta - master - no hint
iz - track - no hint
ebeveyn - parent - no hint
kıyı - shore - no hint
bölünme - division - no hint
levha - sheet - no hint
madde - substance - no hint
iyilik - favor - no hint
bağlamak - connect - no hint
sonrası - post - no hint
harcamak - spend - no hint
akor - chord - no hint
şişman - fat - no hint
memnun - glad - no hint
orijinal - original - no hint
payı - share - no hint
istasyon - station - no hint
baba - dad - no hint
ekmek - bread - no hint
şarj - charge - no hint
uygun - proper - no hint
bar - bar - no hint
teklif - offer - no hint
segmenti - segment - no hint
köle - slave - no hint
ördek - duck - no hint
anlık - instant - no hint
pazar - market - no hint
derecesi - degree - no hint
doldurmak - populate - no hint
civciv - chick - no hint
sevgili - dear - no hint
düşman - enemy - no hint
cevap - reply - no hint
içki - drink - no hint
meydana - occur - no hint
destek - support - no hint
konuşma - speech - no hint
doğa - nature - no hint
aralığı - range - no hint
buhar - steam - no hint
hareket - motion - no hint
yol - path - no hint
sıvı - liquid - no hint
log - log - no hint
demek - meant - no hint
bölüm - quotient - no hint
dişler - teeth - no hint
kabuk - shell - no hint
boyun - neck - no hint
oksijen - oxygen - no hint
şeker - sugar - no hint
ölüm - death - no hint
güzel - pretty - no hint
beceri - skill - no hint
kadın - women - no hint
sezon - season - no hint
çözüm - solution - no hint
mıknatıs - magnet - no hint
gümüş - silver - no hint
teşekkür ederim - thank you - no hint
şube - branch - no hint
maç - match - no hint
sonek - suffix - no hint
özellikle - especially - no hint
incir - fig - no hint
korkuyor - afraid - no hint
büyük - huge - no hint
kardeş - sister - no hint
çelik - steel - no hint
tartışmak - discuss - no hint
ileri - forward - no hint
benzer - similar - no hint
kılavuz - guide - no hint
deneyim - experience - no hint
puan - score - no hint
elma - apple - no hint
satın aldı - he bought - no hint
açtı - led - no hint
zift - pitch - no hint
ceket - coat - no hint
kitle - mass - no hint
kart - card - no hint
bant - band - no hint
halat - rope - no hint
kayma - slip - no hint
win - win - no hint
rüya - dream - no hint
akşam - evening - no hint
durumu - condition - no hint
beslemek - feed - no hint
aracı - tool - no hint
toplam - total - no hint
temel - basic - no hint
koku - smell - no hint
vadi - valley - no hint
ne - nor - no hint
çift - double - no hint
koltuk - seat - no hint
devam etmek - continue - no hint
bloğu - block - no hint
grafiği - chart - no hint
şapka - hat - no hint
satmak - sell - no hint
başarı - success - no hint
şirket - company - no hint
çıkarmak - subtract - no hint
olay - event - no hint
özellikle - particular - no hint
anlaşma - deal - no hint
yüzmek - swim - no hint
vadeli - term - no hint
karşısında - opposite - no hint
karısı - wife - no hint
ayakkabı - shoe - no hint
omuz - shoulder - no hint
yaymak - spread - no hint
düzenlemek - arrange - no hint
kamp - camp - no hint
icat - invent - no hint
pamuk - cotton - no hint
doğmuş - born - no hint
belirlemek - determine - no hint
kuart - quart - no hint
dokuz - nine - no hint
kamyon - truck - no hint
gürültü - noise - no hint
seviyesi - level - no hint
şans - chance - no hint
toplamak - gather - no hint
dükkan - shop - no hint
streç - stretch - no hint
atmak - throw - no hint
parlaklık - shine - no hint
mülkiyet - property - no hint
sütun - column - no hint
molekülü - molecule - no hint
seçin - select - no hint
yanlış - wrong - no hint
gri - gray - no hint
tekrar - repeat - no hint
gerektirir - require - no hint
geniş - broad - no hint
hazırlamak - prepare - no hint
tuz - salt - no hint
burun - nose - no hint
çoğul - plural - no hint
öfke - anger - no hint
iddia - claim - no hint
kıta - continent - no hint
yani - I mean.. - ya need to hear what I mean..
l mean.. ya knee is gone
öyle, böyle - thus, such as, in this way - you are trying to describe the way something behaves and you compare it to an oily substance
öyle yani - I mean this, this is what happened - just like böyle yani, you tell someone what happened, a boy lay on ya knee
böyle yani - I mean that, that's what happened - a boy comes and lays on your knee, and you later you are telling someone and you say "i mean that, that's what happened"
şey - uhhhh - you know you are trying to think of a thing, but you do not know what so you just say thing
ya - well.., ohhh, really? - really? is pretty much the same as in english, but since it is not used as 'yes' slang, it also gets reused as a meaningless filler for the other words like well.. and ohh...