çünkü bulaşık deterjanı almaya giderken telefonumdan arnavutça dersi dinliyorum ve yirmiiki dakikası kaldı - because i'm listening to an albanian lesson on my phone on the way to buy dish soap and i have twentytwo minutes left - 
alışkanlığımı kaybettim - i lost my habit - A Lish can lick you into keeping habits
zihin açıklığı - clarity of mind - A chick licks me and everything is clear
kırılmam - i won't break - A cruel ill mom will never break
belgesel - documentary - A documentary about a bell geese sell
amuda kalkıyorum - doing a handstand - A mood a... Changes when you are in a handstand
dik - steep - A steep dick
bu normalin tersi - this is the opposite of normal - A ter see is the opposite of a sitter
maceralarla dolu rüyalar görürsün inşallah - i hope you have dreams full of adventures - Adventuresly full of
şu anda baş aşağıyım - i'm upside down right now - Ah sh** I'm upside down
ahşap tahtalar - wooden boards - Ah shop only deals with wood
umarım nereden aldığımı hatırlarım - i hope i remember where i got it - All dim in the place i got it
ışık anahtarları - light switches - Anna tars Larry when she flips the switch
omega üç arıyorum - looking for omega three - Are they here are the here, I'm looking everywhere
her zamankinden daha değişikti - it was different than usual - At this time more kin live in dens then ever before
balkabağı - pumpkin - Ball ba.. it.. is not a ball, it's a pumpkin
banyo yapmaya ihtiyacım vardı - i had to go to the bathroom - Banyo.. yap my ahhh... I have to go to the bathroom
bezelye - peas - Bayza ill ya, because she ate peas
bilerek - on purpose - Be Leary of people who wreck things on purpose
değişikti - it was different - Because it was different, they each say ick
benim için sıkıntı değil - no problem for me - Being sick int a problem if you have a good immune system
göz önünde bulundurulduğunda - taking into account - Bull under old dune duh when it is kept here,
bahane - excuse - But honey... This is my excuse
kedi köpekten korkar - cat afraid of dog - Cat from the dog is afraid
bana bir kaşık getirir misin lütfen - can you bring me a spoon please - Cause shook didn't work we need a spoon
derinlerine - deep into - Dare in Lear in deep into a hole,
not defteri - notebook - Deaf terry would always have a notebook
düzelttiklerin için teşekkür ederim - thank you for correcting - Denzel Washington makes a check every time he corrects someone
dondurucu açık - freezer open - Don put the freezer under you jew
keskin bir bıçak var mı - do you have a sharp knife - Don't kiss skin with something sharp,
dört gözle bekliyorum - i'm looking forward to it - Fourward bu the eyes you look
fakat - but - Fuck cat butt but don't really
türkiyenin geri kalanı - rest of turkey - Garry call a nick to see if he has met the rest of turkey
su geçirmez - waterproof - Getch ear mess keeps everything out
bir kase alıyorum - i'm taking a bowl - Give me a bowl cause i say
havlular - towels - Have Lou a towel
çöpü alıp havluları değiştirdi - took the trash and changed the towels - Have Lou some towels?
otelin havuzunu kullanacağım - i will use the hotel pool - Have a zoo the new pool does
arka arkaya iki gün - two days in a row - He built one ark after another ark, ya?
buranın kuzeyinde - north of here - Here's north
aşağı yukarı - more or less - I'll show ya carry, more or less
bağımlıyım - i'm addicted - I'm addicted to ballin em and leavin em,
yani en azından bunu yapmalıyım - so at least i should do this - If you are from the least then you are at least
eğer kendimi yazmaya zorlarsam - if i force myself to write - If you force yourself you can do difficult things
mıknatıslı dolap - magnetic cabinet - Micky mouses gnat is literally stuck to him like a magnet
böylelikle büyük bir daire oluşturdum - so i made a big circle - Oh lush tour is the thing to create
aslında yazıyor olmam gerekir - i should actually be typing - Ole mom gets wrecked if i don't do what i am supposed to 
uyandığımda - when i wake up - Oo yawn, the lights are dim, da.. this is how things are when you wake up
ulusal - national - Ooo lou saw the new national mandate
ama önümüzdeki haftanın sıcak olacakmış - but next week will be hot - Oooo new moos will be on the deck next week
öğrendiklerimden - from what i learned - Or ren dick leary m Dan is from what I learned
basınç uyguluyorlar - they apply pressure - Oy gauhl apply why they learn and practice şt
patlıcan - aubergine - Pat little Jon on the head with an eggplan
buna dayanabilirim - i can stand it - Princess Diana can stand anything
rastgele dolaşırım - i wander randomly - Rasta Man comes randomly
mektebe - to school - School you should make to be a good experience
sivrisinek - mosquito - Seeve re sees nick to find out how to get rid of mosquitoes
iki şekilde yazacağım - i will write it in two ways - She kills a day in many ways
dikkatimi dağıtacak - will distract me - Shu it will distribute your attention when you point your dick at me
sarımsak - garlic - Sir im sucking on your garlic
havlular buraya asılabilir - towels can be hung here - Someone is hung by their asshole
yakında yemek yapacak mısın - will you cook soon - Soon younwilş see ya kin dumb
temizlikçi - cleaner - Ta me lick chair because the cleaner did such a good job
tadı çok güzeldi - the taste was very good - Tada dıs taste is great
dağ tarafına doğru koştum - i ran towards the mountain side - Tear a fin off a fish
bunlar sayesinde daha fazla kart yapacağım - thanks to these i will make more cards - Thanks to these new holy books, sighing is a sin
duşumun küveti yok - my shower doesn't have a tub - The animals do a voup to get the vet into a tub
reyhan - basil - The basil should be in the sun ray hun
sen türkçe bellemişsen - if you remember turkish - The bell misses when you remember something
basınç - pressure - The boss inches closer to you to apply pressure
karo zemin - tile floor - The car oh they mean tile the car floor
gözüme su kaçırmazlar - they don't get water in my eyes - The catcher misses things
çevresinde - around - The chef resigned the paper over and over all around the place he was supposed to
çamaşır makinesi - washing machine - The chum uh sheers the laundry
ellerimi kurutuyorum - i'm drying my hands - The core ought to be dry
onun bu kutuya ne peynir ne şeker koymasına izin ver - let him put neither cheese nor sugar in this box - The coy ma sinner is in to bad things, don't let her put things into you
doğudaki dağlara doğru koştum - i ran towards the mountains in the east - The doe is with the ducky in the east
günün aydın olsun - have a bright day - The dog is intellectual and brightens up when he eyes din
banyo aynasının arkasında işiklar var - there are lights behind the bathroom mirror - The eye know sin when you look in a mirror
fikrimi değiştireceğim - i will change my mind - The fee cream is on my mind
yüzme ile ilgili videolar - videos about swimming - The ill gill is related to the fishes sickness
panjurlar - shutters - The jury uses the window shutters
sana keyifli zamanlar diliyorum - i wish you a pleasant time - The key if you live is to live pleasantly
gitmem lazım - i have to go - The law of him is what has to be done
iniyordu - was descending - The mood was decending in eyor dude
sunum - presentation - The presentation is so new hmmm
oldukça rahatlar - they are quite comfortable - The raw hat is comfortable
rahatlat - relax - The raw hat let me relax
yolculuğum güzeldi - my journey was good - The way of jewels is the journey
tasarlanmış - designed - The way the property is designed if you toss  (stuff onto) our lawn you will miss the stuff
dünya rekoru - world record - The world was here yesterday, ya?
yokuşlu - hilly - The yolk uses the hillmto slide down
çamaşır makinesinin uzatma kablosuna ihtiyacı var - washing machine needs extension cord - There are ooos at ma's extension
bir tencere getirir misin - can you bring a pot - There are ten Jerry's in a pot
yazmam gerektiğini hatırladım - i remembered that i had to write - There is this teeny thing you remember you have to do
birkaç inek gördüm - i saw a few cows - They give the cows e-necks
ilk defa soya küpleri aldım - i bought soy cubes for the first time - They keep the cubes all cooped up in a cube cage
bir sinek - a fly - They see a fly on your neck
su koyda ıslansınlar - soak them in the water - Things get wet in Islans
hangi bölümden başlayacaksın - which part will you start from - This is the part of the movie where a bowl looms over his head
iki kere yemek pişirdim - i cooked twice - This piece here is cooked
bu sefer - this time - This time Lucifer loses and bu sefer wins
karadağ'a geldiğimden beri - since i came to montenegro - To Montengro from coming since
temizlik malzemeleri bu dolapta - cleaning supplies are in this cupboard - To the mal ze mel goes to get materials
nereye gideceğimi bilmiyorum - i don't know where to go - To where i will go(object) i don't know
oruç tutmadığımda - when i'm not fasting - Toot ma dim duhhh when I'm not fasting
valla iyisin - well you are fine - Valla if you are fine
biz de dün ebrarı kırıkkaleye götürdük - we took ebrar to kırıkkale yesterday - We took her to go tour a duck farm
hatırladığıma bakacağım - i will see what i remember - What i remember is that the hatter sand and was dim
düz ekran televizyon - flat screen television - What the heck the screen ran all the way along the way,
vardığımda - when i arrive - When i arrived there existed a dim guy, du
bu uzuyor - this is getting longer - When it gets long it oozes
hava biraz soğumaya başladı - the weather is getting a little cold - When weather is getting cooler you ask yourself so who am I ya
neredeyse hiç - hardly ever - When you are near a day say you are almost to that day
neredeyse oradayım - i'm almost there - When you are near a day you say you are almost there
buzdolabı kapalı - refrigerator closed - When you cup a lip you close it
kiminle konuştuğumu bilmiyorum - i don't know who i'm talking to - Who i am talking to is a con man who used to be in a tomb
iyi yaşa - bless you - Yes our words are law
şimdi bulaşık yıkamaya gidiyordum - i was going to wash dishes now - Yick! Ah my a messy thing I'm going to wash,
etrafta dolaştım - i walked around - You ate a raft as you walked around
burnuma biraz basınç - a little pressure on my nose - You burn new ma on her nose
onun gelişimini izlemek zevkli - it's fun to watch her progress - You come and progress up the chimney,
kalın perde - drape - You get a new pair of curtains every day
nehire gittikten sonra markete gittim - i went to the market after i went to the river - You go somewhere to get a tiki then after that you go somewhere else
sahile yakınım - i am near the beach - You saw he lay at the beach
kendime zaman ayırdım - i took time for myself - You seperate the eye from the ear
ben üşüyorum - i'm cold - You shiver when you're cold
brüksel lahanası - brussels sprouts - You sing while handing a sprout
birincisi tercümesiz ikincisi tercümeli - the first is without translation the second is with translation - You tear a sentence in half (cüm)Le and the translation is inside
taşlı - rocky - You toss rocks at tosh.0
bana yazdıklarını at - throw me what you wrote - You wrote dicks in it
yorumunu sabırsızlıkla bekliyorum - i'm looking forward to your comment - You're uh moo new here, that is my comment,
yolun yarısındayım - i'm half way - Your a sin damn, I'm halfway to you
boşnak böreği meşhur - bosnian pastry is famous - Your eyes bore a hole in the pastry,
yürümeye gidiyorum - i'm going to walk - Your room may walk away
kızartma tavası var mı - do you have a frying pan - Your tough i see, can you bend a frying pan?
yarış - race - Your wish is to win the race
işini düzelttikten - after you fix your job - after you fix your job 
ayrıca - also - also 
neyse - anyway - anyway 
yatağa gitmeden - before going to bed - before going to bed 
nefes tutma egzersizi - breath holding exercise - breath holding exercise 
hücreler - cells - cells 
önce kötü hücreleri yer - eats bad cells first - eats bad cells first 
oruç tutmadığım da - even though i'm not fasting - even though i'm not fasting 
her şey düşünüldu - everything has been considered - everything has been considered 
oruç tutma - fasting - fasting 
dilbilgisi - grammar - grammar 
dil bilgisini - grammar - grammar 
kadar yaygın olduğunu - how common it is - how common it is 
basit cümleler kurabiliyorum - i can form simple sentences - i can form simple sentences 
yazmadım - i did not write - i did not write 
yiyip içmedim - i didn't eat or drink - i didn't eat or drink 
nasıl kuracağımı bilmiyorum - i don't know how to set it up - i don't know how to set it up 
nefesimi tuttum - i held my breath - i held my breath
kiraladım - i rented - i rented 
hatice'nin ailesiyle konuştum - i talked to hatice's family - i talked to hatice's family 
sanırım oruç hakkında daha fazla konuşacağım - i think i'll talk more about fasting - i think i'll talk more about fasting 
ona yorgun olduğumu söyledim - i told him i was tired - i told him i was tired 
yazmaya devam edeceğim - i will continue to write - i will continue to write 
onunla konuşuyorum - i'm talking to him - i'm talking to him 
üç saat oldu - it's been three hours - it's been 3 hours 
son cümle - last sentence - last sentence 
hafıza - memory - memory
zihin - mind - mind 
dil bilgim zayıf - my language skills are poor - my language skills are poor 
günlük - journal - no hint
şekilde - way - no hint
yazacağım - i will write - no hint
birincisi - first - no hint
bir günlük başlatmak istiyorum - i want to start a diary - no hint
şu anda yunanistan atina'dayım - i am currently in athens greece - no hint
dün bir bisiklet aldım - i bought a bike yesterday - no hint
planım kuzeye gitmek - my plan is to go north - no hint
arnavutluk'u görmek istiyorum - i want to see albania - no hint
sanırım arkadaşlarım savage ve chelsea almanya'da olacak ve onları görmek istiyorum - i think my friends savage and chelsea will be in germany and i want to see them - no hint
herkese merhaba - hello everyone - no hint
bu benim günlüğüm ve şimdi günüm hakkında yazacağım - this is my diary and now i will write about my day - no hint
bu sabah bir kafede kahve içtim - i had coffee in a cafe this morning - no hint
soğuk ve lezzetliydi - it was cold and delicious - no hint
onu sevdim - i liked it - no hint
oraya bisikletimle gittim - i went there on my bike - no hint
oraya gitmeden önce rastgele dolaşırım ve kafenin nerede olduğunu bilmiyorum - before i went there i wandered around randomly and i don't know where the cafe is - no hint
şimdi bunu bilgisayarımda yazıyorum ve biraz önce hatice ile konuştum - now i'm typing this on my computer and i just spoke to hatice - no hint
daha sonra bu cümleleri translate ile kontrol edeceğim - later i will check these sentences with translate - no hint
üçüncü gün - day three - no hint
bugün yazamayacağımı düşünmüştüm ama bak işte buradayız - i thought i might not write today but look here we are - no hint
ben tembel değilim - i am not lazy - no hint
ancak belki bu sadece kısa bir giriş olacaktır - however maybe this will just be a short entry - no hint
az da olsa birşeyler yazmak hiç yazmamakdan iyidir - i think a short entry is better than no entry - no hint
bugün erken saatlerde bisikletimi sürdüm - earlier today i rode my bike - no hint
diğer günlere göre biraz daha fazla sürdüm - i didn't ride a lot but i rode more than every other day - no hint
bitirdim - i'm finished - no hint
kısa ve güzel - short and sweet - no hint
bana mesaj attı - he texted me - no hint
kulağa iyi geliyor - sounds good - no hint
karasız - unstable - no hint
kendine iyi bak - take care - no hint
bu benim planımdı - this was my plan - no hint
nasıl sorarsın - how do you ask - no hint
ders çalışırım ya da plaja giderim - i study or go to the beach - no hint
ders çalışacağım ya da plaja gideceğim - i will study or go to the beach - no hint
kolay gelsin - good luck with - no hint
allah zihin açıklığı versin - god give you clarity - no hint
iyi çalışmalar - good work - no hint
o zaman - in that case - no hint
oruspu çocuğu - son of a bitch - no hint
belgesel - documentary - no hint
telefonumdan - from my phone - no hint
giderken - on the go - no hint
iradeyi güçlendirdiği - strengthens the will - no hint
mantar - mushrooms - no hint
hokkabazlık yaptım - i juggled - no hint
coğrafya - geography - no hint
uçmak - fly - no hint
diğer günlere göre - compared to other days - no hint
biraz daha fazla - a little bit more - no hint
yazamayacağımı düşünmüştüm - i thought i couldn't write - no hint
bak işte buradayız - look here we are - no hint
arnavutluku görmek - see albania - no hint
bu cümleler - these sentences - no hint
kontrol edeceğim - i will check it - no hint
güzel bir gün geçirdim - i had a nice day - no hint
bunun hakkında konuşmak istiyorum - i want to talk about it - no hint
öğle yemeği için - for lunch - no hint
akşam yemeği için - for dinner - no hint
ikisi de lezzetliydi - both we're delicious - no hint
iki kere yüzdüm - i swam twice - no hint
bir tane sivrisinek - one mosquito - no hint
ingilizce yazacaktım - i was going to write in english - no hint
bu sefer önce ingilizce yazacaktım unuttum - i forgot i was going to write in English first this time - no hint
almaya giderken - on the way to get - no hint
arnavutça dersi dinliyorum - i'm listening to the albanian lesson - no hint
yirmiiki dakikası kaldı - twentytwo minutes left - no hint
düzeltmeler - fixes corrections - no hint
bütün gün - all day - no hint
kedi yerine köpeği al - get the dog instead of the cat - no hint
zorlaştırmamak - not to complicate - no hint
kolaylaştırdım - i made it easy - no hint
önceki - previous - no hint
önceki cümleyi - previous sentence - no hint
uzun sürdü - took a long time - no hint
çekmek - to pull - no hint
yaklaşık yedi - about seven - no hint
gitmesine izin verdiler - they let him go - no hint
eve geldikten sonra - after coming home - no hint
mağazaya gittim - i went to the store - no hint
tekrar eve geldim - i came home again - no hint
biraz zaman alacak - it will take some time - no hint
durmalıyım - i have to stop - no hint
birkaç gündür günlük yazmadım - i haven't written a diary for a few days - no hint
yolculuk - trip - no hint
ilk yarı - first half - no hint
engebeli - rugged - no hint
gittiğimde - when i go - no hint
muhtemelen - probably - no hint
kuzey - north - no hint
olabilir - it could be - no hint
bunu kısa tutacağım - i will keep this short - no hint
çevirdikten sonra - after turning - no hint
sonrasında - after that - no hint
hazırladım - i prepared - no hint
yemek yerken - while eating - no hint
zaman alacak - it will take time - no hint
ankara başkenttir - ankara is the capital - no hint
bir gölün yanındayım - i'm next to a lake - no hint
sandalet - sandals - no hint
oldukça aktifi - very active - no hint
deniz gözlüğü - goggles - no hint
dört gözle - look forward - no hint
burnuma - to my nose - no hint
yolun yarışı - race of the road - no hint
bir haftada - in a week - no hint
bu yüzden kim bilir - so who knows - no hint
bu yüzden - therefore - no hint
çeviri yaptıktan sonra - after translating - no hint
daha çok yazacağım - i will write more - no hint
aktif - active - no hint
açık hava - open air - no hint
spor salonu - gym - no hint
bisikletime bindim - i got on my bike - no hint
yaklaşık bir buçuk saat - about an hour and a half - no hint
şehirde dolaştım - i walked around the city - no hint
yüzme gözlükleri - swimming goggles - no hint
onları denedim - i tried them - no hint
tutarlar - amounts - no hint
ağrılı - sore - no hint
adında - named - no hint
yunanistan - greece - no hint
dikkatim - my attention - no hint
ne yapacağımı - what to do - no hint
oradayken - while you are there - no hint
isteyeceğim - i will want - no hint
alamayabilirim - i may not receive - no hint
altın - gold - no hint
metod - metod - no hint
sıfat - adjective - no hint
unuttuğum kelimeleri - words i forgot - no hint
efenim - sir - no hint
bana yazılar ver - give me texts - no hint
eksik bir kelime var - there is a missing word - no hint
gitmeye hazırım - i'm ready to go - no hint
belgisiz - unmarked - no hint
plaj - beach - no hint
hamak - hamak - no hint
durum - situation - no hint
günlük tutuyorum - i keep a diary - no hint
en iyi sensin - you are the best - no hint
bence yaygın - i think it's common - no hint
bitmedi - it's not over - no hint
mümkün - possible - no hint
sadece on yaşındaki çocuklar için - only for ten year olds - no hint
küçük çocuklar için - for young children - no hint
daha karpuz kesecektik - we we're going to cut more watermelons - no hint
bulaşık deterjanı - dish soap - no hint
oruç tuttuğumda - when i fast - no hint
göz önünde - in view - no hint
ödlek - coward - no hint
stil - style - no hint
mezar - grave - no hint
sorumluluk - responsibility - no hint
beklediğimden daha fazla - more than i expected - no hint
uzun bir koşuya çıktım - i went for a long run - no hint
on kilometre koşarım diye planlandım - i planned to run ten kilometers - no hint
on altı kilometreden biraz fazla koştum - i ran a little over sixteen kilometers - no hint
koştuğum yer - where i run - no hint
dağa doğru koştum - i ran towards the mountain - no hint
dağlara koştum - i ran to the mountains - no hint
otelime gidiş yolundan farklı bir yoldan geldim - i came by a different route than the way to my hotel - no hint
böylelikle - thus - no hint
daire - apartment - no hint
oluşturdum - i created - no hint
otele geldiğimde - when i come to the hotel - no hint
balık ağı - fishing net - no hint
sayı - number - no hint
tablo - table - no hint
ayakta masa - standing desk - no hint
soğan - onion - no hint
domates - tomatoes - no hint
avokado - avokado - no hint
brokoli - broccoli - no hint
tuz - salt - no hint
gününe devam etmeye hazır mısın - are you ready to continue your day - no hint
hayat sana güzel - life is good to you - no hint
kesin değil - not certain - no hint
kasım - november - no hint
türkiye'yi özledin mi ama doğruyu söyle - did you miss turkey but tell the truth - no hint
yarın doğum günü onun - tomorrow is her birthday - no hint
denize yakınım - i am near the sea - no hint
on kere on nedir - what is ten times ten - no hint
sabırsızlıkla - impatiently - no hint
çöpü - trash - no hint
geliştiriyor - is developing - no hint
izlemek zevkli - fun to watch - no hint
hatice ile çalışmayı bitirdikten sonra - after you finish working with hatice - no hint
tarih - date or history - no hint
matematiğin tarihçesi - history of mathematics - no hint
kırk bir kelime ekledim - i added fortyone words - no hint
bitiriyorum - i'm finishing - no hint
önce ingilizce sonra türkçe - first english and then turkish - no hint
yapmamam gerektiğini - that i shouldn't - no hint
geçen birkaç gün - the past few days - no hint
anki kartları yaptım - i made the anki cards - no hint
ağı olan balıkçılar - fishermen with a net - no hint
çok zamanını aldı - took a lot of time - no hint
yakaladılar - they caught - no hint
doğudaki dağlara - to the eastern mountains - no hint
iki hafta içinde - in two weeks - no hint
pazar günü - sunday - no hint
pazartesi günü - monday - no hint
salı günü - tuesday - no hint
çarşamba günü - wednesday - no hint
perşembe günü - thursday - no hint
cuma günü - friday - no hint
cumartesi günü - saturday - no hint
döndü - returned - no hint
ocak - fireplace - no hint
şubat - february - no hint
mart - march - no hint
nisan - april - no hint
mayıs - may - no hint
haziran - june - no hint
temmuz - july - no hint
ağustos - august - no hint
eylül - september - no hint
ekim - october - no hint
aralık - range or december - no hint
çocuklara kim baktı - who looked after the children - no hint
dün selma onlara baktı - yesterday selma looked at them - no hint
ağaçta neyi gördün erdoğan - what did you see in the tree erdogan - no hint
ağaçta kediyi gördüm baba - i saw the cat in the tree dad - no hint
kutuda ne buldun erdoğan - what did you find in the box erdogan - no hint
şekeri fincandan kim aldı - who took the sugar from the cup - no hint
on kilometre koşmayı planladım - i planned to run ten kilometers - no hint
bulaşık mı kullanmıyorsunuz - don't you use the dishes - no hint
sofrada yemeye alıştık - we are used to eating on the traditional sheet - no hint
fakir - poor - no hint
doydun mu - are you full - no hint
çok doydum - i'm so full - no hint
çikolata yiyeceğim - i will eat chocolate - no hint
temizleyeceğim - i will clean - no hint
bugün çok anki kart yaptım - i made a lot of anki cards today - no hint
ama kaç tane bilmiyorum - but i don't know how many - no hint
gidiyorum artık - i'm leaving now - no hint
kahvesi meşhur - famous for coffee - no hint
zemin - ground - no hint
kapı - gate - no hint
koyu kahverengi kapı - dark brown door - no hint
beyaz duvar - white wall - no hint
yeşil kanepe - green sofa - no hint
kağıt havlu - paper towel - no hint
prizi - socket - no hint
fırın - oven - no hint
dondurucu kapalı - the freezer is closed - no hint
lavabo - washbasin - no hint
dolap - cabinet - no hint
küçük beyaz lamba - small white lamp - no hint
ince perde - sheer curtain - no hint
bar sandalyesi - bar chair - no hint
modem - modem - no hint
klima çok iyi çalışıyor - air conditioner works very well - no hint
filmi durduruyorum - i stop the movie - no hint
aç olduğum için yemek yiyorum - i eat because i'm hungry - no hint
çöpü çöpe atıyorum - i throw the trash away - no hint
filme başlamalı mıyım - should i start the movie - no hint
yemek alıyorum bir şey ister misin - i'm getting food do you want something - no hint
bu film çok mu korkunç - is this movie so scary - no hint
bu film çok mu sıkıcı - is this movie so boring - no hint
başka bir şey izlemek ister misin - do you want to watch something else - no hint
bulaşıkları yıkamak zorunda değilsin sadece rahatla - you don't have to do the dishes just relax - no hint
cidden onları beraber yıkayabiliriz gel otur - seriously we can wash them together come sit down - no hint
bulaşık yıkıyorum - i am washing the dishes - no hint
kanın başıma gittiğini hissediyorum - i feel the blood go to my head - no hint
hiçbir zaman ingilizce düşünmeyi zaman kaybı olarak görmedim - i never saw thinking in english as a waste of time - no hint
bu bitki sukulent - this plant is succulent - no hint
bu ne tür bir bitki bilmiyorum - i don't know what kind of plant this is - no hint
bence bu bikti lavanta - i think this plant is lavender - no hint
bu sanatsal bir lavabo - this is an artistic sink - no hint
ellerini bu sabunla yıka - wash your hands with this soap - no hint
bu prizi çalişmıyor - this plug is not working - no hint
bu prizi bozuk - this plug is broken - no hint
bu kutu güzel kokuyor - this box smells good - no hint
tuvalette oturuyorum - i'm sitting on the toilet - no hint
bu tuvalet kağıdı - this toilet paper - no hint
burası bisikletimi tuttuğum oda - this is the room where i keep my bike - no hint
şehre - to the city - no hint
bugün ne mektebe gittim ne de şehre - i neither went to school nor to the city today - no hint
bugün ne okula gittim ne de şehre - i neither went to school nor to the city today - no hint
o halde - in that case - no hint
iyi çok ol - be very good - no hint
yalnız bir şehir gördüm - i only saw one city - no hint
oraya beş altı defa gittim - i went there five or six times - no hint
çok az kaldı - im almost there - no hint
geldim geldim - i came i came - no hint
çok yaşa - bless you - no hint
ahmet gitti mi - has ahmed gone - no hint
ahmet mi gitti - is ahmed gone - no hint
kitabı size verdiler mi - did they give you the book - no hint
selma iki çocuğu gördü mü - did selma see the two children - no hint
niçin parayı bize vermediniz - why didn't you give us the money - no hint
gelsinler mi gelmesinler mi - should they come or not - no hint
ahmet niçin gelmesin - why shouldn't ahmet come - no hint
hiçbir şey içmedi - didn't drink anything - no hint
hiç ankaraya gittiler mi - have they ever been to ankara - no hint
gazeteyi babaya verdin mi - did you give the newspaper to your father - no hint
odada ne buldun - what did you find in the room - no hint
orada hiçbir şey bulmadım - i didn't find anything there - no hint
ahmet gazeteyi okusun mu okumasın mı - should ahmet read the newspaper or not - no hint
tuvaletimi yapıyorum - i'm going to the bathroom - no hint
bulaşık mı yıkıyorsun - are you washing the dishes - no hint
neden masa kullanmıyorsunuz - why don't you use table - no hint
hiç istanbula gittiniz mi - have you ever been to istanbul - no hint
dün o mu geldi - did he come yesterday - no hint
dün mü geldi - did it come yesterday - no hint
dün geldi mi - did he come yesterday - no hint
o mu geldi - did he come - no hint
geldi mi - did he come - no hint
kız hiç gülmedi - the girl never laughed - no hint
hiç gitmedi mi - never gone - no hint
radyo sahibi - radio owner - no hint
radyonun sahibi - owner of the radio - no hint
ev sahibinizin radyosunu kimin otomobiline koydular - whose car did they put your landlord's radio in - no hint
halı - state or rug - no hint
kaşık mı çatal mı istersin - do you want a spoon or a fork - no hint
bu tahta kaşığı kullanabiliriz - we can use this wooden spoon - no hint
bir kase ister misin - do you want a bowl - no hint
bana bir tabak getirir misin - can you bring me a plate - no hint
yatak odası - bedroom - no hint
yatak odam - my bedroom - no hint
onun yatak odası - his bedroom - no hint
halının sahibi - the owner of the carpet - no hint
halının bir sahibi - an owner of the carpet - no hint
bir halının bir sahibi - an owner of a carpet - no hint
halıların sahibi - owner of carpets - no hint
halıların bir sahibi - an owner of carpets - no hint
halı sahibi - carpet owner - no hint
bir halı sahibi - owner of a carpet - no hint
halı sahipleri - carpet owners - no hint
halının iki sahibi - two owners of the carpet - no hint
iki halı sahibi - two carpet owners - no hint
bahçeni gördüler - they saw your garden - no hint
bahçesini gördüler - they saw your garden - no hint
onların bahçesini gördüler - they saw their garden - no hint
onların bahçelerini gördüler - they saw their gardens - no hint
babasının evi istanbul'da - his father's house is in istanbul - no hint
kız annesine güldü - the girl laughed at her mother - no hint
kitabını buldu - found his book - no hint
çocuklar annelerine baktılar - the children looked after their mother - no hint
kitaplarını bulmadılar - they didn't find their book - no hint
senin kitaplarını bulmadılar - they didn't find your books - no hint
parayı evlerinde buldu - found the money in their home - no hint
parayı onların evinde buldu - found the money in their house - no hint
parayı ahmedin ceplerinde buldu - he found the money in ahmed's pockets - no hint
çocuklarınız dün sabah ahmedin annesinin evinde iki saat kaldılar - your children stayed at ahmet's mother's house for two hours yesterday morning - no hint
küçük oğlunuzun ceplerinde ahmedin babasının beş lirasını buldum - i found ahmet's father's five liras in your little son's pockets - no hint
kendi kitabım - my own book - no hint
kendi kitabı - own book - no hint
kendi kitabın - your own book - no hint
kendi kitabınız - your own book - no hint
kendi kitapların - your own books - no hint
kendi kitaplarımız - our own books - no hint
kendi kitaplarınız - your own books - no hint
onların kendi kitapları - their own books - no hint
kendine geldi - he came to himself - no hint
kendi kendine geldi - he came of his own accord - no hint
baban kim - who is your father - no hint
şehrin suyu çok iyi - city water is very good - no hint
babaları oraya girmesinler - don't let their parents go there - no hint
halı sahibi parayı aldı - carpet owner took the money - no hint
türk alfabesi kolay - turkish alphabet easy - no hint
türk lisanı zor mü - is turkish language difficult - no hint
ders odamız sıcak - our classroom is warm - no hint
ama hala türkçe öğrendiğim için sorun yok - but it's okay since i'm still learning turkish - no hint
birkaç cümle yazmak uzun sürmüyor - it doesn't take long to write a few sentences - no hint
yazdığım ilk şey - first thing i wrote - no hint
karadağ'ın başkentindeyim podgerisa - i am in the capital of montenegro podgerisa - no hint
bugün belki kestireceğim - maybe i'll take a nap today - no hint
sadece üç dört saat uyudum - i only slept three or four hours - no hint
sadece ne kadar özel olduğunu bilmeni istiyorum - i just want you to know how special you are - no hint
kesinlikle sana yeşil kart verecekler - they will definitely give you a green card - no hint
bakabilir miyim - may i look - no hint
bil bakalım ne oldu - guess what happened - no hint
dört yere sordum ama hiç yok - i asked four places but none - no hint
zaten beyza ile misin - are you already with beyza - no hint
panjurlar sıkışmış - shutters stuck - no hint
ders odamızda kimi buldunuz - who did you find in our lecture room - no hint
kardeşimin ev sahibi otomobilini babamın garajına koydu - my brother's landlord put his car in my father's garage - no hint
otomobil beyoğlundan istanbul üniversitesine gitti - the automobile went from beyoğlu to istanbul university - no hint
küçük kız kardeşinin çay fincanları güzel - your little sister's teacups are beautiful - no hint
ev sahibimin kendi evi istanbul caddesinde - my host's own house is on istanbul street - no hint
oğlunun ayakları büyük - your son has big feet - no hint
küçük kardeşinin ismi ne - what is your little brother's name - no hint
ahmedin kız kardeşi dün gece niçin kız kardeşlerinin evine gitmedi - why didn't ahmed's sister go to her sisters' house last night - no hint
hiç beyoğluna gittin mi - have you ever been to beyoğlu - no hint
neredeyse bir hafta oldu yazmadım - i haven't written for almost a week - no hint
bu sabah nehirde yüzdüm - i swam in the river this morning - no hint
eve geldiğimde onları pişirdim - i cooked them when i got home - no hint
şu anda programlama yapacağım - i'm programming right now - no hint
belki az yazarsam yarın daha çok yazarım - maybe if i write less i will write more tomorrow - no hint
yazı yazmanın çok uzun ve zor olduğunu düşünmek istemiyorum - i don't want to think that writing is too long and hard - no hint
ama kısa kısa yazarsam başka günler evet yazı yazabilirim diyebilirim kendime - but if i write short i can say to myself that i can write on other days - no hint
fakat bu çok kısa olacak çünkü başka şeyler de yapmak istiyorum - but this will be very short because i want to do other things too - no hint
marketten yeni çıktım - i just left the market - no hint
düştün mü - did you fall - no hint
düş aldın mı - did you dream - no hint
bahçelerine gördüler - they saw in their garden - no hint
düş aldım - i had a shower - no hint
duşta mıydın - we're you in the shower - no hint
ıspanak - spinach - no hint
okumayı çok sever - loves to read - no hint
o kitabı okumadan size verdim - i gave it to you without reading that book - no hint
oraya gitmek çok zor - it is very difficult to go there - no hint
ingilizcede bu söz ne demek - what does this word mean in english - no hint
onu görmeye geldiler - they came to see him - no hint
yüzmek bilmez - can't swim - no hint
ingilizcede bilmezler mi - don't they know english - no hint
postacı günde iki defa gelir - the postman comes twice a day - no hint
ben eve gelir gelmez size telefon ettim - i phoned you as soon as i got home - no hint
bu sabah onu okumadan bana verdi - gave it to me this morning without reading it - no hint
son zamanlarda ne yapıyorsun - what are you doing lately - no hint
buranın doğusunda - east of here - no hint
buranın güneyinde - south of here - no hint
dağlık bir ülke mi - is it a mountainous country - no hint
yüzme gözlüklerimi gördün mü - have you seen my swimming goggles - no hint
birkaç dakika önce bisikletime bindim - a few minutes ago i got on my bike - no hint
kapının yanında tutuyorlar - they keep it by the door - no hint
sorunlar - problems - problems 
dil öğrenmede gerçekten iyi - really good at learning languages - really good at learning languages,
bilim insanları - scientists - scientists 
iyi ki varsın - so glad i have you - so glad i have you 
iradeyi güçlendirdiği - strengthens the will - strengthens the will 
kelimenin anlamını - the meaning of the word - the meaning of the word 
kumsala - to the beach - to the beach 
denize - to the sea - to the sea 
gelenek - tradition - tradition 
iki paragraf - two paragraphs - two paragraphs 
irade - will - will 
yaratacaktı - would create - would create 
daha uzun yazmak - write longer - write longer 
günlük yazarken - writing a diary - writing a diary 
çalışmayı bitirdin - you finished working - you finished working 
yapmam gereken başka şeyler var - i have other things to do - İ have to put gears on a can
filmi durdurmalı mıyım - should i stop the movie - İ should mull it over
kestirdim - i took a nap - İ took a nap and kiss tear in a dream
buzdolabı açık - refrigerator open - İce cabinet
eritecek - will melt - İf You Air it out, it will melt
barfiks çektim - i did a pullup - İf the bar fix i can check if Tim will do a pull up
ilgili - relating to - İl gill and li are all relating to each other
buranın batısında - west of here - İn the West bat is sin
bu giderek uzuyor - this is getting longer - İncreasingly people re getting in wrecks
bir haritaya baktım - i looked at a map - İt is hard to eat a map
sarı tabure - yellow stool - İt is ok to bury the stool
ama sonra alışıyordum - but then i got used to it - İt was weird when they said a Lish instead of a list, but then i got used to it
