Turkish Conversations

Yüreğimin bir parçası - a piece of my heart
yüreğimin köşesi - corner of my heart
endişelenme - do not worry
masallah - wow
buldüşmek - to meet
Şehre - to the city
Girmek - to enter - when you enter into a place, you become one of the gears in that place
Bile - even
Çabuk - quickly
koşuya - running
enstrüman - instrument
Ateş - fire
Ateşte - in the fire
Evde - in the house
yakalamak - to catch - ya collar caught the ball
çantamdaydı - it was in my bag
evrensel - universal
yabancı - foreign
misafirler - guests
gerekmek - to be required - get wrecked! This is what's required
gerekiyor - is required
kim umrunda ki - who cares (sarcastic)
kimi umursuyorsun - who do you care about
O halde - in that case
Boş zamanlarında ne yapıyorsun - what do you do in your spare time
bu gerçekten yardımcı bir söz - this is a really helpful phrase
Boş zaman - free time.
son zamanlarda - recently
12 çıvarında - around 12
Bir arada - are together
normalde de geç mi uyursun - do you normally stay up late?
bu yüzden - thats why
avrupa yakası - European side
anadolu yakası - Anatolian side (Asian Side of Istanbul)
asya yakası - Asian side
kolay gelsin sana - come easy to you
bu yanlış mı - is this wrong
bu doğru mu - is this correct
ne demek istiyorsun - what do yo mean
başka - what else
kimin umrunda - who cares - who + whom ruined da.. ah, who cares..
iyi şanslar - good luck
doydun mu - are you full
hatırım için - for my sake
ne için - for what
acelem var - im in a hurry
en iyi dileklerimle - best wishes
öyle umuyorum - i hope so
sakin ol - calm down
bu arada - by the way 
kaç kere - how many times 
yakında bir arama yapmak için müsait olacağım - i will be available soon to do a call - literally, soon a call make for available i will be. when a moose eyes it, the other moose's knows it's available.
uyuyorsun - you are asleep
ama genellikle sadece türkçe üzerinde çalışıyorum - but usually I am just working on turkish
ne tür sporlar yaparsın - what type of sports do you do
iş nasıldı - how was work
çok destekleyicisin - You are so supportive
arkadaşın olduğum için şanslıyım - i am lucky to be your friend
çekmiştim içimden - i was deep inside
en sevdiğin komik filmler mi - are funny movies your favorite
umarım iyi bir gün geçirmişsindir - i hope you have had a good day
bence öyle - sort of, i think so
ne çalışmalıyız - what should we study
bana bir soru soracaksın - you will ask me a question
Hayır maalesef her şeyi anlamadım - No unfortunately, i didn't understand everything
sanırım anladım - i think i understood
"llll" demelisin - you should say "llll"
sözlerin çok dikkate değer - your words are very noteworthy
ben uyanığım - i am awake
"lll" kulağa daha iyi geliyor - "llll" sounds better - literally, to the ear more good it comes
kalbim eridi - my heart melted
yürüyüşün nasıldı - how was your walk
senden naber - what's up with you
iyilik sağlık - it's all good
yok bir yaramazlık - can't complain
iyidir, .... yapıyorum - it's fine. i'm just doing ....
uğraşıp duruyoruz. ne olsun. - not much. been keeping busy.
bugün pek bir şey yapmadık - I haven't done much today
ama dün gece yaklaşık 1:00 geç kalktım - but last night i was up late, about 1:00
sınav dışında bugün ne yaptın - other than the exam, what did you do today
anladığını umuyorum - i hope you understood me
Bana yardım için teşekkür ederim - thank you for helping me
sanırım tenis oynayacağım - i think i will play tennis
sanırım kardeşlerimle tenis oynayacağım - i think i will play tennis with my brothers
programlayacağım  - i will program
program yapacağım - i will do programming
llllll veya iiiiii hangisi doğru - llllll or iiiiii which is correct
bu cümle benim için yeni - this phrase is new to me
beni anlayabildiğine sevindim - im glad you could understand it
evet bunu demek istedim - yes, this is what i wanted to say
üzgünüm dedim sandım. - sorry i thought i said
tekirova küçük bir kasabadır - tekirova is a small town
sebze kavurmayı severim - i love roasting vegetables
inanılmaz bir yeteneğin var - you have an incredible talent
şaka mı yapıyorsun - are you joking
Kardeşlerim arasında çok yaş farkı var - There are many age differences between my siblings
did i say your name correctly - ismini doğru söyledim mi
otuz dört yaşındayım - i am thirty four 
Kaç yaşındasınız - how old are you
what do you do for fun - eğlenmek için ne yaparsın
bugün ilginç bir şey yaptın mı - did you do anything interesting today
selamlar - greetings
have you had a good day - iyi bir gün geçirdin mi
iyidir, senden - fine, you (respons to naber) - literally, it is good, from you
ne yapıyorsun - what are you doing
evet bende güzel bir gün geçirdim - yes i too have had a good day
bugün ne yaptın - what did you do today
güzel bir gün gibi geliyor - sounds like a nice day
umarım iyisindir - i hope you are doing well
ve umarım iyisindir - and i hope you are well
umarım günün iyi geçiyordur - i hope your day is going well
burada hala erken - it is still early here
ben pek yapmadım - i have not done much
mutfağı temizledim - i cleaned the kitchen
şimdi hızlıca duş almam gerekiyor - now i need to take a quick shower - now fast a shower take required
biraz önce uyandım. - i woke up a little bit ago.
az önce kahve yaptım. - i just made a coffee.
Çamaşırlarımı çamaşır makinesine koydum. - I put my laundry in the washing machine. - a chum a sheers your laundry
bugün geç uyudum - i slept in late today
iyi bisiklet sürdüm - i had a good bike ride
dünden önceki gün pek uyumadım - i didn't sleep much
iyi uyudum - i slept well
günüm şimdiye kadar iyi geçti ama hala erken - my day has been good so far, but it is still early
günün nasıldı? eğlenceli bir şey yaptın mı? - how was your day? did you do anything fun?
what do you do for fun - eğlenmek için ne yaparsın
is this an old book - bu eski bir kitap mı - an example of an old thing is a ski
which series were you watching? - hangi diziyi izliyordun - you watch someone who is laying down
i havn't seen Queens Gambit - Queens Gambit görmedim
surely watch the Queens Gambit - The Queens Gambit mutlaka izle
bu bir dizi - it is a series
sadece ilk bölümü izledim - i have only watched the first episode
ama bir sonrakini izleyeceğim için heyecanlıyım - but i am excited to watch the next
instagram gönderilerimin çoğunu beğendin - you liked so many of my instagram posts
o festival çok havalı görünüyor - that festival looks very cool
ama jonglörlük festivali ile aynı zaman - it is the exact same time as the juggling festival
Geçenlerde A izledim, bende iyi olduğunu düşündüm - i just watched A recently, i thought it was good too
sevdiğim başka bir diziyi hatırladım - i remembered another series i like - literally, i like another series i remembered
Do you have siblings? - Kardeşin var mı?
sen en yaşlı mısın - are you the oldest
ben ikinci çocuğum - i am the second child
evli misin - are you married
kızın kaç yaşında - how old is your daughter
very sweet, that is a great age - çok tatlı, bu harika bir yaş
üç yaşında bir yeğenim var - i have a niece who is 3
sorumluluğum yok ama çok eğleniyorum - i have no responsibilities, but lots of fun
Evcil hayvanım yok - i have no pets
ama erkek kardeşimin bir kedisi var - but my brother has a cat
balığınızın bir adı var mı - does your fish have a name - literally, fish a name exist?
koşuya gittim - I went for a run
kahve aldım - I got coffee
verimli bir sabah geçirdim - I have had a productive morning
evet, ingilizce'de circus - yes, in english it is circus
neden türkçe öğrenmek istiyorsuniz - why do you want to learn Turkish
siz bana ingilizce öğreten ben de size türkçe - you teach me english and I'll teach you turkish
türkçeme iltifat ettiğin için teşekkür ederim - thank you for complimenting my turkish
ingilizcenden çok etkilendim - i am very impressed with your english
Bir gün senin kadar iyi konuşmayı umuyorum - I hope to speak as good as you someday
senin kadar iyi - as good as you - your amount good, llike the amount of your goodness
şimdi çeviri çok kullanıyorum - now i use translator a lot
türkçe yaz - write turkish
daha fazla konuşma pratiğine ihtiyacım var - i need to practice speaking more
benim telaffuzum doğru mu - is my pronunciation correct
yeter be her şey yanlış - enough, everything is wrong
daha doğal - more natural
A ve B arasındaki fark ne - what is the difference between A and B?
gayet'i cümle içinde kullanabilir misin - can you use 'gayet' in a sentence
güzel bir dil - it is a beautiful language
rusçayı nasıl öğrendin - how did you learn russian
ne zamandır Helllo tallkk kullanıyorsun - how long have you been using helllo tallkk
kağıda zamirleri yazdım - I wrote pronouns on paper
sometimes it seems impossible - bazen imkansız görünüyor
tek başıma cümle kurmalıyım - i need to make a sentence on my own
çok çeviri kullanıyorum - i use translate a lot
çok güzel bir aksanın var - you have a very nice accent
türkçem olduğundan daha iyi görünüyor - my turkish seems better than it is
türkçem göründüğü kadar iyi değil - my turkish is not as good as it seems - literally, my turkish seems as good as not
türkçem göründüğünden daha iyi - my turkish is better than it seems - literally, my turkish than it seems more good
tavsiyen için teşekkürler - thank you for your advice 
çok haklısın, konuşmak öğrenmenin en iyi yolu - you are very correct, speaking is the best way to learn
türkçe konusunda yardıma ihtiyacım var - i need help with turkish
beni anlıyor musun - can you understand me
okumaya çalışıyorum, zor - i'm trying to read, it is hard
türkçe konuşmamı sevmene çok sevindim, bana motivasyon veriyor - im very happy that you like when i speak turkish, it gives me motivation
ne dediğimi anlıyor musun - could you understand what i said
Neredensin - where are you from (country/broad location) - literally, what place from are you
nerelisin - where are you from(nationality) - people with your nationality are nearly ever seen around here
türkiyenin neresindensin - where in turkey are you from
Türkiye'nin neresinde yaşıyorsun - What part of Turkey do you live in
hangi şehirdensin - which city are you from
amerıkada çok yıldır lakin bundan önce scotland daben - in america for many years but before that in scotland - scottish is coach, ya?
azerbaycan türküyüm - I am Azerbaijani Turkish
Orada mı doğdun - were you born there
Ne zaman ayrıldın - when did you leave
aksanını seviyorum - i love your accent
şu anda burada çok kar yağıyor - it is snowing a lot here right now
olduğun yerde hiç kar yağar mı - do you ever get snow where you are 
burada kar yağması çok sıradışı - it is very unusual for it to snow here
oraya yaklaşık dört yıl önce gittim - I went there about four years ago
hayır hiç etmedim - no i never did
orayı ziyaret ettin mi - have you visited there
yurtdışına çıktın mı - have you ever left turkey
hayır hiç gitmedim - no i've never gone
ben seni gezdiririm - i'll show you around
hayır maalesef çıkamadım - no, unfortunetly I haven't left
param yok çünkü - because I don't have money
geçen yil üç ay türkiyede yaşadım - last year i lived in turkey for three months
işin çok seyahat etmene izin veriyor mu - does your job allow you to travel much
bazı güzel yerlere gittin - you have been to some nice places
USA'de nereyi ziyaret etmek istersin - where in the US do you want to visit
bu yaz gelmek istiyorum - i want to come this summer
pandemiye bağlıdır - it depends on the pandemic
tekrar seyahat etmeye çok hazırım - i am very ready to travel again - how's your ear, are you ready? literally, again travel make very ready
tüm hayatım seyahat ediyor - my whole life is travelling
ama çok seyahat ederim - but i travel a lot
kadıköy yakınlarında kaldım - i stayed near kadıköy
hiç yurtdışına çıktın mı - have you ever traveled abroad
ama belki türkiye'de daha yaygındır - but maybe in turkey it is more common
arkadaşlarımın istanbulda sirk merkezi var - my friends have a circus center in istanbul
orada sirk dersleri veriyorlar - they teach circus classes there
öğrenci misiniz - are you a student
ne okuyorsun - what do you study
kimya okuyorum - I study chemistry
Sınavında nasıl geçtiğini öğrendin mi? - Did you find out how you did on your exam?
bugün okulun var mıydı - did you have school today
daha kaç yılın var - how many more years do you have
kaç yıldır üniversitede okuyorsun - how many years have you been in university
sınavın nasıl gitti - how did your exam go
umarım iyi gitmiştir - i hope it went well
bu bir okul toplantısı mı - is it a school meeting
gerçek bir sınıfa geri dönebildiğin zaman çok güzel olacak - it will be so nice when you can be back in a real classroom
öğrencilerin kaç yaşında - what age are your students
ne öğretiyorsun - what do you teach
ne zamandır öğrettin - how long have you taught
Ben bir öğretmendim - i was a teacher
kaç öğrenciniz vardı - how many students did you have?
çalışıyor musunuz - do you work 
ben bir hokkabazım - I am a juggler
Ben bir sirk sanatçısıyım - I am a circus performer
ama birçok işim oldu - but i have had many jobs
işin çok seyahat etmene izin veriyor mu - does your job allow you to travel much
yaz üniversite bittiğinde ne yapacaksın - what will you do in the summer when university is done
evet bu çok eğlenceli bir iş. Ne iş yapıyorsun? - yes it is a very fun job. what is your job?
iç mimarlık - interior design
Ne iş yapıyorsun - what is your job
ne zamandır oyuncu olmak istedin - how long have you wanted to be an actress
bilimi gerçekten iyi bilmen harika - o cool, you must know science really well
oyunculuğun iyi olduğunu düşünüyorum - i think the acting is good
kaba olan kız, sanırım adı sezon - the girl who was mean, i think her name is season
Bunu çok isterim - i would like that very much - lit, this much i want
arkadaş olmak istiyorum - i want to be friends
komiksin beni güldürüyorsun - you're funny, you make me laugh
oh benim, çok komiksin - oh my, you're so funny
çok güzel bir aksanın var - you have a very nice accent
aksanını seviyorum - i love your accent
bende seninle oynamayı çok isterim - i would love to play with you too
Çok zarifsin - You are so elegant
bunu söylediğin için minnettarım - i appreciate you saying this
teşekkür ederim tatlısın - thank you, you are sweet
çok teşekkür ederim çok naziksin - thank you very much, you are very kind
ama çok tuhaf bir başkan oldu - but he was a strange president
koşuta çıkıyorum - I'm going for a run
sana iyi uykular - sleep well
Gitmek zorundayım - i have to go
seninle konuşmak çok güzeldi - it was very nice talking to you
gecenin geri kalanının tadını çıkar - enjoy the rest of your night
ve yakında seninle konuşmayı umuyorum - and i hope to talk to you soon
umarım yakında tekrar konuşabiliriz - hopefully we can talk again soon
kesinlikle şu anda uyuyorsun - certainly you are asleep right now
bir hayalim vardı - i had one dream
sık sık rüya görür müsün - do you dream often
umarım şu anda hayallerinde maceralar yaşıyorsundur - i hope you are having adventures in your dreams right now
keske olsa - if only
every day one learns something new - insan her gün yeni bir şeyler öğreniyor zaten
neyse söyliyim bari - let me just say anyway - ney sayers will find problems anyways, barry obama wants to at least day one thing..
bir sorum var - i have a question
o beni gayette seviyor - well obviously he loves me
sen uyumuyor musun çok geç - don't you sleep? it is so late
boşver, şimdi biliyorum - nevermind, i know now
Gün henüz yeni başladı - the day has just begun
bu zor geliyor - that sounds tough
isim üstte - the name is at the top
ikisini de beğendim - i liked both of those
dünden önceki gün - the day before yesterday
buradaki her şey mükemmel - everything here is perfect
ne yazık ki - unfortunately - literally, what pity that. it is a pity that ya zick because it's worse than being sick.
seni instagramda buldum - i found you in instagram
ne demek istiyorsun - what do you mean
bir sorum var - i have a question
ve sana yardım edebilirim - and i can help you
ama uzun sürmez - but not for long
hiç A görmedim - ive never seen A
özür dileyecek hiçbir şey yok - there is nothing at all to apologize for
zor sorular iyi sorulardır - hard questions are good questions
şimdiye kadar iyi - good so far - literally, to now until
evet, bu harika olur - yes, that would be great
ilki en iyisidir - is the first one the best
yani belki iyidir - so maybe it is good
ama o olduğunu düşünüyorum - but i think it is
Hala beklemek için bir buçuk saatim var - i still have an hour and a half to wait
kendi kendime konuşuyordum - i was talking to myself
peki onun yerine ne yapıyorsun - so what do you do instead
A ile B arasındaki fark nedir - what is the difference between A and B
o ağlamakta iyidir bence - she is good at crying i think
senle konuşacağım - i will speak with you
diğer arkadaşlarımla konuşacağım - i will speak with other friends
attım mesaj - i sent a message
yaygın ifade - common expression
bu tam cümle - this is the full sentence
fotoğraf çekmek - Take photos
kişisel algıladım - ı took it personally
içimden bir şarkı yazmak gelmişti - i felt like writing a song
bu yaygın bir ifade mi - is that a common expression
programlamayı severim - i like to program
dün sabah çekmiştim - I took it yesterday morning (film)
şahsen konuşmak benim için zor - it is hard for me to speak in person
göndermeden önce - before sending
normalde bir mesaj göndermeden önce çeviri yapabilir ve pratik yapabilirim - normally i can translate and practice before i send a message
şimdi kullanabileceğim bazı sözlerim var - i have some phrases I can use now
türkçe pratik yaptım - i practiced turkish
şu anda sadece türkçe pratik yapıyorum - right now just practicing turkish
yapalım şunu - let's do it
buraya bakalım - lets see here
ne yapıyorum - what am I doing
ama bu sabah erken saatlerde - but earlier this morning
yürüyüşe çıktım - i went for a walk
hokkabazlık yaptım - i juggled
arabayı temizledim - i cleaned the car
biraz su içtim - I drank some water
bence hepsi bu - i think that is all
Biraz sonra muhtemelen tenis ya da koşarak egzersiz yapacağım - in a little bit i will probably exercise, either tennis or running - literally, a little later probably tennis or running excersise i will do. when you run you share a rock with someone you are running with.
kardeşimi bir yere sürdüm, şimdi onu bekliyorum - i drove my brother somewhere, now i am waiting for him
sadece koşuya gittim - i just went for a run 
şimdiye kadar - until now
Öyleyse sür ve koş bugün şimdiye kadar yaptığım tek şey - so drive and run is all i have done so far today
Bugün dışarı çıktın mı? - did you go out today?
belki pazara? veya bir parka mı? - maybe to the market? or to a park?
dersin iyi gitti mi? - did your lesson go well?
sonuçları zaten aldın mı - do you already have the results
verimli - productive - to be productive is very him, lee
geçirmek - spend (time) - get here so we can spend time
yeşillik - greens(weed) - yes, ill like some weed
yaklaşık - about - the yak that sings(la) shakes around this time every day
eğlenmek - to have fun - ellen likes to have fun
sınavında - on the exam - the sin of teachers is the exam
geçtiğini - has passed - my time of get(ting mar)tinis has passed
öğrendin - you learned - learning consists of oral and written (or ret) stuff
yanıt - response - ya nit pick someones response to your question
uyku - sleep - once the enemy is asleep, you call your partner over to do the coup, "oy, coup"
uyumak - to sleep - is is someone turns to sleep, so you tell them, "oy, you!"
zaten - already - the name satan was already taken, so you choose zaten
gezdirmek - to show around - you show someone around and you gaze at deer
lakin bundan - but from that, but before that - you look in what you have been talking about and then say something from before then
iltifat - compliment - you compliment someone on their ill tea fat, fat that looks like a tea shirt
ingilizcenden - from your english - literally, inglish your from
etkilenmek - to be touched/impressed - it killin me how impressive you are!
kadar iyi - as good as - cud are something that goes again and again, like as something as
umuyorum - I hope - it is a slightly more satisfied om that I hope for
çevirmeni - translator - chef hear many foreign words and becomes a translator
kağıt - paper - here is the paper, kut it
zamir - pronoun - pronouns are za mirror to everything
imkan - possibility - if it is a possibility, him can do it
imkansız - impossible - without possibility
evcil hayvan - pet - literally domestic animal. house(ev) jail makes someone domestic. there are animals high in a van
diziyi - series - a really good series makes you dizzy because it is so good (iyi)
izlemek - to watch - you ease onto the couch and lay down to watch a show
mutlaka - absolutely - foot locker for mute people is absolutely real and it is called mutlaka
yurtdışına - abroad - in foreign lands they live in yurts and have dis in a yurt kitchen
koşuta - running - when there are two shooters you should be running
generelikle - usually - similar to generally
gayet - well - guy ate very much food
internette - on the internet - pretty much the same
i need - ihtiyacım - there is a need for ET togo to(a) the gym
boşver - nevermind - the bush's are very much like 'nevermind, nevermind' when people bring up their wars
arasındaki - between - they are arresting a ducky for hiding between two buildings
kötü - bad - it is bad to cut you
fena - bad(sometimes good/attractive) - it is bad to fain a person who is already cold, but sometimes it is good to fan a person
sıfat - adjective - you sift through all the people who use the adjective fat
tek - alone - when you are alone, it is easier for someone to take you
bekar - single - if you have a bad car you are more likely to be single
bâkir - virgin/copper - I can tell from back here that you are a virgin, virgin are made of copper
tuhaf - strange - it is strange when something does not have two halves
başkan - president - the president bashes whoever he wants because he can
yanlış - wrong - someone says something wrong and you mocingly yawn and think it is delicious
yeter - enough - ya tar someone and they yell, enough! enough!
telaffuz - pronunciation - if your pronunciation is bad, you tell a fuz(zy) statement
çıkamadım - i couldn't go out - from çıkmak chicks like to go out, the difference between didn't and couldn't is that there is an extra 2 vowel harmony in there, like you couldn't do it because there was too much extra to do
çıkmadım - i didn't go out - from çıkmak chicks like to go out
söyleyemedim - i couldn't say - the difference between didn't and couldn't is that there is an extra 2 vowel harmony in there (with y buffer), like you couldn't do it because there was too much extra to do
söylemedim - i didn't say - normal rules, from söylemek
fark - difference - there is a difference between a fark and a fork
neyse - anyways - nay sayers will think of problems anyways
bari - at least - at least we can barry our heads in the sand
doğal - natural - a doe is all natural
vay - wow - the german says wow, vhy are you so amazing? or.. wow, these things vi for the most amazing thing ever
yanmak - burn - watching the fire burn makes you yawn
fotoğrafın - your photograph - pretty much the same with the 4n ending
hokkabaz - juggler - juggling is hokey, but it is the latest buzz
sanatçı - performer - sanatra was a great performer
rusçayı - russian(language) - russian tea ya drink while speaking russian
doğmak - to be born - a doe is born at it is very natural(doğal) to be born
ayrılmak - to leave - i real(ly) will leave
şovda - in the show - you shove someone into the show, and it has the da ending
heyecanlıyım - im excited - you are excited to see john, hey ye john!, and it has the lıyım ending
kızın - your daughter - you kız your daughter, you are surprised when you hear that the person you are talking to named their daughter cousin
yaş - age - you can not wash your age away
yeğen - niece/nephew - in japan nephews and nieces are used as currency(yen)
sorumluluk - responsibility - "i am responsible for my question(sorum), lu", and when you look at responisbile it becomes a noun responsibility
izin - permission - when you are a kid you need permission to get an Ezine
bittiğinde - when finished - from bitmek
bitmek - to finish - you are finished when you are beat
zorunda - I have to - there is something difficult(zor) you are under so you have to do it
geri kalan - the rest - garry will stay with you the rest of your life
tadını - taste - you can not taste anything until(ta), dinner(dinna)
çıkarmak - to eject - chicks are being ejected from eggs
Zevk olmak / tadını çıkarmak / eğlenmek - to enjoy - you enjoy having a house at the end of the alphabet(zev), k?, literally, taste + eject, you enjoy it when a bad taste goes out of your mouth, ellen enjoys everything she does
an - moment - we are currently on this moment
anda - in the moment - we are currently on this moment, with the in ending da
şu anda - if you are that in the moment then it is right now
yerde - on the ground - a year is the ground we stand on, with the de ending for on
kar yağar - it snows - car covered in snow, it snows/rains so ya are going to be cold/wet
sıradış - out of the ordinary - it is out of the ordinary that sarah dish washes
gibi geliyor - sounds like - literally, like comes, when something similar comes to mind, it sounds like this
başıma - by myself - all by myself i bash a ma
kurmalıyım - i have to install - kurmak, the cure is to install, establish and build things, then with a lıyım ending
kurmak - to install - the cure is to install, establish and build things
cümle - sentence - a jewish zoom type show where they lay around and make sentences
eğlenceli - fun(adjective) - when ellen has fun she turns to jelly
iç - inner - each house has an inner
mimarlık - architecture - mimar is architect, means are make by architects, and when architects like architecture
hala - still - the crazy guy is still out there hollering
hata - mistake - hatters always point out mistakes
pek - very - chicken peck very much
temizlemek - to clean - the root is clean, and you have to have a clean court to play tennis, and cleaning is a french action (le)
mutfağı - kitchen(as an object) - mute people are so quiet they can fuck in the kitchen, normal consonant substitution witht he k to ğ
beğenmek - to like - everyone reluctantly likes themselves, be-en
ikisi de - both - it is literally, the two also
tavsiye - advice - thanks for the advice, it is (tough) for me to (see) things that way, (yay)
çamaşır - laundry - that chum(p) a sheer(ed) my clothes!
makine - machine - i make machine that makes my key neigh
koydum - i put - you put koy in a fish tank
ummak - to hope - you om for peace and you um for things you hope for or expect
yaz - summer - it is nice to write in the summer
pandemiye - pandemic - in turkey they are excited about the pandemic, so it is pretty much the same word, but with a yay at the end
bağlıdır - it depends on - it depends on the baller, dear
minnettarım - i appreciate - i appreciate that the men they tarred him
söylediğin - what you said - just the to say verb with the ending that makes it be in the what + verb format
aksan - accent - it sounds like accent with an accent that gets rid of the final t
bazı - some - same root as basen(sometimes)
place - yer - a year is a time place
haklısın - you are correct - you are correct, a hawk listens very well
duş - shower - only a douche doesnt shower
gerekmek - to be required - it is required that you go reck your life
üstte - on top - you stay on top because you are the best
hayallerinde - in your dreams - literally, dream plural your in, you say "hi all" to all the dream characters
macera - adventure - ma jeer(s) a(t) my advenures
gönderisi - post(internet) - i post that im gone dear and he see it
çoğunu - most of - same root as çok
kesinlikle - absolutely - if kissing is likely you are absolutely thrilled
uyuyorsun - you are sleeping - you are excited that someone is sleeping and you kind of stutter, ew, you - your sleeping
merkezi - center - a center is like a market but it is crazy. or, you are in a horse center and the mare there is crazy
seyahat - travel - you are travelling and there are lots of vendors who say a hat would be a nice thing to buy, you say a hat is a good thing to have when you travel
hazır - ready - hows her, is she ready?
konuşmamı - my speech - same root as speak, and your mommy is going to hear it because it is 
gitmiştir - went(event passed) - has the go, gitmek root
iyisindir - you are fine - literally, fine you are
bölüm - episode - every episode starts with a balloon with an m on it
sonrakini - the next - the next thing is the key we need
havalı - cool(swanky) - when the wqeather(hava) is li(t), it is really cool
jonglörlük - juggling - jong lore looks really cool, like juggling
mükemmel - perfect - a cow(moo) as funny as jimmy kimmel would be perfect
dediğimi - what I said - literally, say past what me definite
hayal - dream - you say "hi al" in a dream
sık sık - often - you are sick so often that you say it twice
rüya görür - he dreams - he uses his dream to rue his gorer
sihirbaz - wizard
gerçek - real
sınıfa - to class
geri - back
dönebildiğin - you can return(as a clause)
toplantı - meeting
geçenlerde - recently
olduğunu - that it is (clause)
başka - another - you bash another car
hatırlamak - to remember - the mad hatter sings(la) to remember things
sürmez - does not last
özür - apology - losers don't give appologıes, özürs do
dilemek - to wish - i wish they would delay the show
özür dilemek - to apologize
sorular - questions
bence - I think
oynatmak - to play
zarif - elegant
olur - would be / fine
lise - high school
kolej - college
yani - so
buçuk - half - the audience boos and they chuck out half of them
kendi - own / self
kendime - myself - i give me a candy to me, myself
yerine - instead
arasındaki - between - they are arresting a ducky for hiding between two buildings
fark - difference
nedir - what
oyuncu - player / actor - oy! un jew is the best actor in the world!
eğlenceli - enjoyable
bilim - science
oyunculuğun - your acting
oynamak - to act (film) - an actor says oy! to get someone's attention, then says na! when the wrong person looks
kaba - rude - it is rude to your father to ca(ll) him ba instead of baba
olan - the one - o the lawn is amazing, this house is the one!
sanmak - to think (implies wrong assumption)
düşünmek - to think (cognitive action)
bence - in my opinion
ağlamak - to cry - all uh the people cry because of allah
yaygın - common
stresliyim - i am stressed
atmak - throw away / send - you send something away at somewhere on a horse (at)
mesaj - message
yaygın - common
ifade - expression
tam - full
cümle - sentence - a jewish zoom type show where they lay around and make sentences
çekmek - take(photos)
algılamak - detect / sense
kişisel - personal
içimden - inside of me
şarkı - song
şahsen - in person
kullanabileceğim - i will be able to use
söz - statement - so's this what your statement is?
yapalım - let's do
bakalım - let's see - I'm going to back a limb in this robot fight, so let's see here which limb should i back?
saatlerde - in the hours
hepsi - all (adverb/noun)
muhtemelen - probably - if you try to mute a melon you will probably be successful
egzersiz - exercise - for the excercise, the eggs ear must be seized
şimdiye - to now
dışarı - out
sonuç - result
doymak - to be full
hatır - sake / respect - the mad hatter remembers(hatırmak) me for my sake
hatırmak - to remember - the mad hatter remembers me for my sake(hatır)
acel - in a hurry - when you are in a hurry you just eat a gel pack
dilek - wish - a good with is a delectible thing
kere - times
müsait - available
üzerine - over
desteklemek - to support
çekmek - attract
sanırmak - to think
demelisin - you should say
değer - value - they are of great value
dikkate - consideration
uyanık - awake
ayrıca - also
Kulak - ear
kalp - heart
erimek - to melt - erie makes you melt
yürümek - to walk - you walk to your room
naber (ne haber) - what's up - you ask your neighbor whats up
nolsun - not much
iyilik - it's fine
iyilik - favor
sağlık - health
yaramazlık - mischief
uğraşmak - to deal / struggle - oooo rash, deal with and struggle with thay
durmak - to stand / stop
dışında - outside / except for - put the dish in the sink, except for this one, leave it outside
beğendim - i like it
Üzgünüm - i'm sorry
kasaba - town - towns have casas and bars, but they are small so they have to cut off the end of bars(ba)
kavurmak - roast - when you roast something you should cover it
yetenek - talent - ya ten (year old can juggle with just their) neck
şaka - joke - a joke is a shocker to common thinking
farkı - difference