

once upon a time - bir zamanlar - no hint
in a farm - çiftlikte - no hint
the animals had nothing to eat - hayvanların yiyecek hiçbir şeyi yoktu - no hint
they we're very hungry - onlar biz çok açız - no hint
so they decided to cook - bu yüzden pişirmeye karar verdiler - no hint
the little red hen - küçük kırmızı tavuk - no hint
found a wheat seed - buğday tohumu buldum - no hint
and rushed to tell her friends - ve arkadaşlarına anlatmak için koştu - no hint
perhaps they would help her - belki ona yardım ederlerdi - no hint
plant the seed - tohumu ek - no hint
who will help me - bana kim yardım edecek - no hint
plant this wheat - bu buğdayı ek - no hint
cow will you help me - inek bana yardım edecek misin - no hint
to plant this seed - bu tohumu ekmek - no hint
not i - ben değil - no hint
it's too sunny to do it - bunu yapmak için çok güneşli - no hint
pig will you help me - domuz bana yardım edecek misin - no hint
dog will you help me - köpek bana yardım eder misin - no hint
to plant the seed no - tohum dikmek için hayır - no hint
then i shall do it all alone - o zaman hepsini tek başıma yapacağım - no hint
so the little red hen planted the seed - küçük kırmızı tavuk tohumu ekti - no hint
all by herself - hepsi tek başlarına - no hint
several days went by - birkaç gün geçti - no hint
there was a bright sunshine - parlak bir güneş ışığı vardı - no hint
it rained - yağmur yağdı - no hint
the little red hen decided to weed - küçük kırmızı tavuk ot yemeye karar verdi - no hint
who will help me weed this seed - bu tohumu ot için bana kim yardım edecek - no hint
weed the garden - bahçeyi otla - no hint
with the garden - bahçe ile - no hint
the weather is too pleasant - hava çok hoş - no hint
okay then i will do it - tamam o zaman yapacağım - no hint
so the little red hen weeded and tended - küçük kırmızı tavuk otları ayıkladı ve eğildi - no hint
as the week's went by - hafta geçtikçe - no hint
the sun ripened the wheat - güneş buğdayı olgunlaştırdı - no hint
until it was ready to harvest - hasat için hazır olana kadar - no hint
the wheat had grown tall and strong - buğday uzun ve güçlü büyümüştü - no hint
so the little red hen decided to ask her friends to help her - küçük kırmızı tavuk arkadaşlarından ona yardım etmelerini istemeye karar verdi. - no hint
thresh the wheat - buğdayı harmanlamak - no hint
cow will you help me thresh the wheat - inek buğdayı harmanlamama yardım eder misin - no hint
i want to rest - dinlenmek istiyorum - no hint
in my barn today - bugün ahırımda - no hint
pig will you help me thresh the wheat - domuz buğdayı harmanlamama yardım eder misin - no hint
i want to play - oynamak istiyorum - no hint
in the mud today - bugün çamurda - no hint
dog will you help me thresh the weed - köpek otu harmanlamama yardım eder misin - no hint
not i not i - ben değil ben - no hint
i want to find my bone - kemiğimi bulmak istiyorum - no hint
in the doghouse today - bugün köpek kulübesinde - no hint
ok then i will do it - tamam o zaman yapacağım - no hint
all alone - yapayalnız - no hint
no one helped little red hen - küçük kırmızı tavuğa kimse yardım etmedi - no hint
so once again she had to do all the work by herself - bu yüzden bir kez daha tüm işi kendi başına yapmak zorunda kaldı - no hint
so she thrashed the wheat - bu yüzden buğdayı dövdü - no hint
after she finished - o bitirdikten sonra - no hint
she asked her friends - arkadaşlarına sordu - no hint
to help her - ona yardım etmek için - no hint
grind the wheat into flour - buğdayı un haline getirmek - no hint
who will help - kim yardım edecek - no hint
grind the wheat into flour - buğdayı un haline getirmek - no hint
cow will you help me grind the wheat into flour - inek buğdayı un haline getirmeme yardım eder misin - no hint
it's too close to milking time - sağım zamanına çok yakın - no hint
pig will you help me grind the wheat into flour - domuz buğdayı un haline getirmeme yardım eder misin - no hint
it is too close to suppertime - akşam yemeğine çok yakın - no hint
dog will you help me grind the wheat into flour - köpek buğdayı un haline getirmeme yardım eder misin - no hint
it is too close - çok yakın - no hint
suppertime - yemek zamanı - no hint
okay then i will do it - tamam o zaman yapacağım - no hint
so the little red hen ground the wheat into flour all by herself - küçük kırmızı tavuk buğdayı tek başına un haline getirdi - no hint
the little red hen decided - küçük kırmızı tavuk karar verdi - no hint
to bake her flour into bread - ununu ekmek yapmak için - no hint
she decided - o karar verdi - no hint
to give her friends another chance - arkadaşlarına bir şans daha vermek için - no hint
to help her - ona yardım etmek için - no hint
who will help me bake this flour - bu unu pişirmeme kim yardım edecek - no hint
into bread - ekmek içine - no hint
bake this flour into bread - bu unu ekmek yapmak - no hint
i don't know how to bake - nasıl pişireceğimi bilmiyorum - no hint
bake this flour - bu unu pişir - no hint
not i not i - ben değil ben - no hint
dog will you help - köpek yardım edecek misin - no hint
not - değil - no hint
i not i i don't know how to bake - ben yemek yapmayı bilmiyorum - no hint
the little red hen baked the bread - küçük kırmızı tavuk ekmeği pişirdi - no hint
all by herself - hepsi tek başlarına - no hint
when it was done - ne zaman yapıldı - no hint
she let it cool - soğumasına izin verdi - no hint
for a while - bir süre - no hint
before she knew it - o bunu bilmeden önce - no hint
the time came - zaman geldi - no hint
to cut - kesmek - no hint
and eat the bread - ve ekmeği ye - no hint
looking around - etrafında seyir - no hint
she didn't see anyone - o kimseyi görmedi - no hint
i wonder who will help me eat this bread - bu ekmeği yememe kim yardım edecek merak ediyorum - no hint
i will i will i will - yapacağım yapacağım - no hint
no you won't - hayır yapmayacaksın - no hint
i did all the work - tüm işi yaptım - no hint
i get the rewards - ödülleri alıyorum - no hint
of that work - o işin - no hint
this bread - bu ekmek - no hint
